CustomerId,Recency,MntWines,MntFruits,MntMeatProducts,MntFishProducts,MntSweetProducts,MntGoldProds,MntTotal,MntRegularProds
1,58,635,88,546,172,88,88,1529,1441
2,38,11,1,6,2,1,6,21,15
3,26,426,49,127,111,21,42,734,692
4,26,11,4,20,10,3,5,48,43
5,94,173,43,118,46,27,15,407,392
6,16,520,42,98,0,42,14,702,688
7,34,235,65,164,50,49,27,563,536
8,32,76,10,56,3,1,23,146,123
9,19,14,0,24,3,3,2,44,42
10,68,28,0,6,1,1,13,36,23
11,59,6,16,11,11,1,16,45,29
12,82,194,61,480,225,112,30,1072,1042
13,53,233,2,53,3,5,14,296,282
14,38,3,14,17,6,1,5,41,36
15,23,1006,22,115,59,68,45,1270,1225
16,51,53,5,19,2,13,4,92,88
17,20,84,5,38,150,12,28,289,261
18,91,1012,80,498,0,16,176,1606,1430
19,86,4,17,19,30,24,39,94,55
20,41,86,2,73,69,38,48,268,220
21,42,1,1,1725,1,1,1,1729,1728
22,63,867,0,86,0,0,19,953,934
23,0,384,0,102,21,32,5,539,534
24,69,270,3,27,39,6,99,345,246
25,89,6,4,25,15,12,13,62,49
26,4,173,4,30,3,6,41,216,175
27,26,36,2,42,20,21,10,121,111
28,96,684,100,801,21,66,0,1672,1672
29,34,8,4,10,2,2,4,26,22
30,56,112,17,44,34,22,89,229,140
31,31,110,0,5,2,0,3,117,114
32,8,96,12,96,33,22,43,259,216
33,4,482,34,471,119,68,22,1174,1152
34,55,40,0,19,2,1,3,62,59
35,37,702,17,151,0,8,35,878,843
36,76,6,3,14,15,7,36,45,9
37,99,55,0,6,2,0,4,63,59
38,53,437,8,206,160,49,42,860,818
39,3,421,76,536,82,178,102,1293,1191
40,88,13,1,29,3,0,7,46,39
41,4,9,0,6,3,1,3,19,16
42,19,3,1,10,3,2,12,19,7
43,72,123,164,266,227,30,174,810,636
44,24,3,18,14,15,22,50,72,22
45,92,13,6,15,3,5,13,42,29
46,39,826,50,317,50,38,38,1281,1243
47,29,245,19,125,37,67,14,493,479
48,2,650,37,780,27,167,32,1661,1629
49,54,12,6,20,30,1,3,69,66
50,54,510,120,550,156,40,241,1376,1135
51,57,328,9,124,12,24,109,497,388
52,55,984,51,432,180,120,190,1767,1577
53,30,295,35,482,121,120,40,1053,1013
54,31,13,0,8,2,1,5,24,19
55,63,447,0,28,0,0,43,475,432
56,12,712,26,538,69,13,80,1358,1278
57,18,452,18,102,16,18,6,606,600
58,26,523,7,134,37,14,169,715,546
59,8,546,0,48,0,6,6,600,594
60,29,398,40,367,119,122,30,1046,1016
61,75,1,3,6,3,6,15,19,4
62,0,10,0,1,0,0,0,11,11
63,19,688,14,309,201,24,38,1236,1198
64,4,247,49,159,7,82,109,544,435
65,90,856,59,487,58,29,73,1489,1416
66,1,496,36,460,189,60,12,1241,1229
67,29,258,107,291,84,37,86,777,691
68,88,565,6,65,0,6,19,642,623
69,58,14,10,13,4,15,9,56,47
70,68,2,1,6,2,1,1,12,11
71,34,721,111,925,97,18,18,1872,1854
72,40,1032,105,779,137,105,51,2158,2107
73,12,1,0,5,0,3,9,9,0
74,9,577,0,64,0,0,51,641,590
75,87,64,4,68,7,5,17,148,131
76,5,4,1,5,2,0,4,12,8
77,87,25,5,19,7,0,23,56,33
78,56,112,17,44,34,22,89,229,140
79,18,163,23,424,27,65,76,702,626
80,95,17,8,14,10,4,3,53,50
81,48,130,0,16,0,0,5,146,141
82,3,292,6,37,0,3,34,338,304
83,70,350,60,568,110,133,145,1221,1076
84,79,135,9,39,4,0,7,187,180
85,69,15,2,10,0,1,4,28,24
86,84,27,2,14,0,0,0,43,43
87,30,5,3,11,12,5,9,36,27
88,72,505,0,26,0,0,75,531,456
89,37,51,2,7,0,1,2,61,59
90,44,207,26,447,75,0,223,755,532
91,32,135,46,92,65,61,11,399,388
92,0,53,1,5,2,1,10,62,52
93,43,41,1,6,2,0,5,50,45
94,59,386,172,183,185,132,111,1058,947
95,68,562,81,276,80,40,81,1039,958
96,35,217,76,690,50,26,38,1059,1021
97,94,1,3,6,10,0,9,20,11
98,15,144,1,32,2,1,7,180,173
99,56,295,106,271,75,98,65,845,780
100,17,76,3,31,4,4,27,118,91
101,18,454,194,106,31,22,43,807,764
102,46,425,115,292,23,35,79,890,811
103,40,1332,17,311,23,51,86,1734,1648
104,27,527,0,21,0,0,60,548,488
105,95,490,44,125,29,20,22,708,686
106,19,378,0,101,0,0,72,479,407
107,27,64,1,21,0,1,27,87,60
108,25,547,99,812,151,82,33,1691,1658
109,74,47,90,94,123,103,120,457,337
110,85,12,5,25,0,9,30,51,21
111,37,1,6,7,11,5,3,30,27
112,65,320,48,133,39,72,48,612,564
113,13,34,3,29,0,4,10,70,60
114,63,9,0,7,3,4,7,23,16
115,83,17,0,14,7,3,2,41,39
116,69,722,27,102,44,72,168,967,799
117,87,162,33,124,40,28,172,387,215
118,37,450,133,951,173,0,216,1707,1491
119,51,70,0,16,0,0,4,86,82
120,72,492,19,110,16,12,12,649,637
121,10,120,58,73,65,89,58,405,347
122,42,534,5,47,0,5,41,591,550
123,10,236,106,189,23,41,130,595,465
124,51,220,0,33,3,0,23,256,233
125,21,796,14,590,38,44,0,1482,1482
126,31,0,1,3,10,6,9,20,11
127,61,53,1,34,2,0,16,90,74
128,37,15,0,8,4,2,20,29,9
129,74,17,1,12,3,1,4,34,30
130,46,962,61,921,52,61,20,2057,2037
131,4,738,0,232,13,20,50,1003,953
132,73,399,28,756,36,40,126,1259,1133
133,47,614,16,132,43,33,33,838,805
134,13,32,34,41,73,16,116,196,80
135,36,598,16,141,32,41,49,828,779
136,47,2,1,18,20,11,16,52,36
137,49,6,1,10,0,1,4,18,14
138,94,73,3,90,12,1,32,179,147
139,65,42,16,29,12,20,8,119,111
140,59,295,21,78,39,13,13,446,433
141,96,346,17,48,23,13,13,447,434
142,28,233,20,57,8,20,91,338,247
143,12,5,7,24,19,14,20,69,49
144,57,888,0,57,0,0,76,945,869
145,10,997,26,269,34,13,42,1339,1297
146,4,212,6,69,4,12,3,303,300
147,49,8,1,7,2,0,0,18,18
148,3,42,11,57,10,28,14,148,134
149,64,536,11,387,149,91,57,1174,1117
150,0,5,0,3,0,0,5,8,3
151,20,1349,16,249,43,16,33,1673,1640
152,91,53,3,49,7,4,5,116,111
153,9,1001,12,240,16,12,12,1281,1269
154,83,18,1,32,6,3,28,60,32
155,27,125,16,98,134,21,27,394,367
156,63,212,5,33,7,0,2,257,255
157,46,277,162,305,173,76,124,993,869
158,84,15,10,19,8,17,20,69,49
159,58,7,3,10,8,1,7,29,22
160,78,12,4,6,11,8,16,41,25
161,4,85,7,24,2,3,27,121,94
162,17,81,0,6,0,0,6,87,81
163,77,59,0,12,0,0,48,71,23
164,56,1149,71,449,69,71,26,1809,1783
165,79,847,66,119,86,89,111,1207,1096
166,90,29,0,14,0,0,2,43,41
167,96,2,0,5,2,0,1,9,8
168,44,207,26,447,75,0,223,755,532
169,81,152,3,22,2,5,7,184,177
170,77,12,11,10,3,12,9,48,39
171,21,620,26,195,34,17,141,892,751
172,16,47,1,6,0,0,12,54,42
173,80,1,9,7,2,14,10,33,23
174,45,10,1,18,10,4,7,43,36
175,63,35,0,2,0,0,2,37,35
176,34,356,0,107,19,9,117,491,374
177,14,783,30,537,140,76,15,1566,1551
178,13,42,1,18,3,0,4,64,60
179,52,1,4,10,29,0,36,44,8
180,98,466,22,432,147,113,102,1180,1078
181,93,23,3,21,3,19,22,69,47
182,38,235,6,45,8,9,12,303,291
183,24,10,0,10,3,1,7,24,17
184,80,656,16,106,32,16,8,826,818
185,82,519,17,813,27,173,51,1549,1498
186,20,344,189,482,50,33,172,1098,926
187,81,96,1,79,7,1,79,184,105
188,50,448,4,34,6,4,39,496,457
189,60,265,138,553,224,23,92,1203,1111
190,63,587,43,337,42,87,54,1096,1042
191,54,763,29,138,76,176,58,1182,1124
192,72,22,0,13,0,0,3,35,32
193,5,6,4,1,7,2,15,20,5
194,88,7,6,13,7,6,14,39,25
195,50,81,18,113,47,13,21,272,251
196,99,54,0,7,0,0,4,61,57
197,17,1170,48,320,42,32,192,1612,1420
198,11,72,24,68,65,4,8,233,225
199,18,613,22,319,33,102,12,1089,1077
200,70,224,0,30,0,0,10,254,244
201,21,410,0,59,19,9,44,497,453
202,66,239,10,554,254,87,54,1144,1090
203,79,171,7,171,25,19,89,393,304
204,2,12,0,4,0,0,1,16,15
205,81,1076,16,417,42,48,16,1599,1583
206,24,182,4,33,0,0,66,219,153
207,48,824,32,162,42,32,43,1092,1049
208,93,30,11,25,29,1,18,96,78
209,56,377,10,540,80,30,10,1037,1027
210,3,520,7,154,19,0,14,700,686
211,44,155,1,25,0,1,3,182,179
212,38,897,23,207,15,11,92,1153,1061
213,46,131,0,16,2,1,39,150,111
214,84,297,7,79,0,11,182,394,212
215,27,787,20,204,0,0,92,1011,919
216,72,792,86,740,67,51,17,1736,1719
217,66,4,1,9,3,0,0,17,17
218,30,231,7,137,4,15,39,394,355
219,2,983,76,184,180,138,27,1561,1534
220,65,3,1,8,4,3,3,19,16
221,37,0,4,5,6,0,4,15,11
222,89,562,21,464,28,10,32,1085,1053
223,49,5,9,20,6,8,21,48,27
224,46,18,0,4,0,0,1,22,21
225,32,415,5,124,15,35,11,594,583
226,54,5,3,10,12,7,20,37,17
227,98,901,61,757,186,163,20,2068,2048
228,97,382,114,276,75,124,38,971,933
229,75,14,1,7,2,1,1,25,24
230,8,559,153,503,218,13,181,1446,1265
231,37,789,0,133,0,28,152,950,798
232,31,11,0,5,0,0,1,16,15
233,40,1218,16,272,104,0,80,1610,1530
234,74,925,64,179,133,12,77,1313,1236
235,90,864,134,768,150,38,172,1954,1782
236,57,960,28,183,220,70,70,1461,1391
237,59,16,3,25,6,1,13,51,38
238,52,3,3,7,0,2,11,15,4
239,5,168,148,444,32,172,148,964,816
240,92,45,47,52,21,20,25,185,160
241,77,650,28,353,45,42,30,1118,1088
242,35,24,0,8,0,0,1,32,31
243,48,918,21,118,13,10,21,1080,1059
244,97,138,33,87,28,24,12,310,298
245,95,12,4,2,10,6,10,34,24
246,24,11,0,4,0,0,2,15,13
247,60,1,2,8,4,3,13,18,5
248,46,554,41,215,11,0,24,821,797
249,85,167,2,62,24,13,7,268,261
250,31,9,0,6,4,1,5,20,15
251,9,177,2,71,3,2,20,255,235
252,30,38,4,22,4,2,20,70,50
253,47,483,84,398,205,84,241,1254,1013
254,70,77,2,35,0,1,69,115,46
255,13,182,74,298,162,149,116,865,749
256,11,10,7,19,8,2,21,46,25
257,31,778,44,499,95,73,146,1489,1343
258,15,16,7,23,0,8,6,54,48
259,2,167,0,43,6,2,13,218,205
260,55,13,2,14,8,7,4,44,40
261,38,33,6,40,3,7,10,89,79
262,86,625,7,99,10,22,7,763,756
263,56,216,162,224,101,92,162,795,633
264,29,68,129,396,188,22,15,803,788
265,30,196,0,512,33,130,54,871,817
266,64,635,15,100,20,7,131,777,646
267,46,4,19,9,28,25,17,85,68
268,84,297,7,79,0,11,182,394,212
269,20,84,5,38,150,12,28,289,261
270,74,204,7,149,20,15,66,395,329
271,18,26,0,8,0,0,3,34,31
272,75,15,6,20,4,5,20,50,30
273,17,304,98,230,150,74,74,856,782
274,88,285,28,242,55,114,135,724,589
275,19,395,183,565,166,141,28,1450,1422
276,62,248,3,81,4,3,51,339,288
277,11,20,6,5,0,9,12,40,28
278,74,39,0,56,20,8,14,123,109
279,32,777,129,573,216,21,203,1716,1513
280,76,8,3,22,21,1,13,55,42
281,6,9,1,3,0,4,8,17,9
282,62,1241,0,80,0,13,40,1334,1294
283,20,6,4,7,4,3,8,24,16
284,43,65,4,16,0,4,11,89,78
285,45,395,15,263,60,54,38,787,749
286,34,801,0,80,0,0,35,881,846
287,53,36,0,12,2,2,10,52,42
288,44,513,14,154,19,0,28,700,672
289,89,37,0,46,4,3,0,90,90
290,43,80,15,93,20,13,52,221,169
291,68,14,1,21,2,3,25,41,16
292,44,525,147,112,219,147,63,1150,1087
293,64,1,26,25,17,23,15,92,77
294,85,675,11,400,15,45,11,1146,1135
295,93,509,0,27,0,0,10,536,526
296,12,154,2,46,20,4,15,226,211
297,86,3,5,14,2,12,17,36,19
298,28,25,0,8,2,0,2,35,33
299,42,768,44,561,77,44,14,1494,1480
300,13,185,0,28,3,2,17,218,201
301,86,24,0,7,0,0,1,31,30
302,59,44,4,21,6,0,27,75,48
303,30,91,64,128,65,3,50,351,301
304,33,11,0,7,3,1,6,22,16
305,23,412,5,119,38,29,77,603,526
306,81,3,3,7,6,2,9,21,12
307,6,16,0,3,0,0,1,19,18
308,41,731,60,353,78,12,73,1234,1161
309,78,424,17,118,7,23,41,589,548
310,49,792,0,275,45,45,126,1157,1031
311,39,21,2,28,3,2,9,56,47
312,3,22,1,11,0,1,2,35,33
313,37,33,0,5,0,0,0,38,38
314,22,68,7,59,10,5,11,149,138
315,79,9,1,6,3,0,4,19,15
316,46,40,2,15,8,0,6,65,59
317,82,909,11,218,0,0,23,1138,1115
318,10,23,1,13,2,2,18,41,23
319,51,11,2,9,3,0,8,25,17
320,38,317,46,247,151,46,139,807,668
321,10,797,153,293,72,97,30,1412,1382
322,14,10,2,16,11,2,21,41,20
323,18,856,61,570,40,25,122,1552,1430
324,95,456,19,832,75,118,38,1500,1462
325,11,37,32,38,11,3,18,121,103
326,65,1103,0,45,0,0,34,1148,1114
327,71,378,14,68,19,14,14,493,479
328,13,1,6,7,0,1,3,15,12
329,58,204,34,204,172,153,173,767,594
330,65,30,0,9,0,0,3,39,36
331,0,189,104,379,111,189,218,972,754
332,33,15,0,12,7,3,7,37,30
333,90,9,0,3,0,0,4,12,8
334,95,495,33,255,11,33,8,827,819
335,93,656,80,455,52,107,93,1350,1257
336,38,452,20,514,13,30,0,1029,1029
337,18,546,91,410,119,0,22,1166,1144
338,57,1048,0,217,0,0,12,1265,1253
339,45,22,2,14,0,1,10,39,29
340,61,78,0,11,0,0,10,89,79
341,6,561,64,785,84,128,48,1622,1574
342,65,629,17,177,69,0,8,892,884
343,52,269,15,69,15,19,38,387,349
344,87,736,163,818,212,163,61,2092,2031
345,38,512,0,83,0,0,41,595,554
346,53,19,3,10,11,8,6,51,45
347,31,9,0,6,4,1,5,20,15
348,67,247,8,160,6,8,65,429,364
349,65,404,0,92,28,27,142,551,409
350,64,333,0,815,129,42,29,1319,1290
351,82,2,3,20,6,11,9,42,33
352,27,833,33,549,151,133,233,1699,1466
353,63,789,0,142,12,9,38,952,914
354,66,10,4,7,0,6,3,27,24
355,69,159,4,45,6,2,38,216,178
356,52,7,1,6,3,1,11,18,7
357,45,977,12,253,16,12,101,1270,1169
358,2,38,4,22,3,3,3,70,67
359,86,57,0,27,0,0,36,84,48
360,23,3,9,15,13,2,39,42,3
361,13,10,4,14,4,4,1,36,35
362,14,1043,24,97,32,24,157,1220,1063
363,92,3,9,13,2,12,12,39,27
364,38,11,0,5,0,0,1,16,15
365,74,3,6,5,0,2,6,16,10
366,14,43,12,96,78,40,55,269,214
367,94,73,3,90,12,1,32,179,147
368,33,12,0,1,0,0,6,13,7
369,32,4,7,7,6,4,13,28,15
370,11,314,11,53,4,3,107,385,278
371,78,571,50,142,33,50,159,846,687
372,56,70,0,11,2,8,23,91,68
373,57,866,21,151,28,21,86,1087,1001
374,7,594,134,786,33,134,57,1681,1624
375,0,140,4,61,0,13,4,218,214
376,66,375,152,335,93,91,81,1046,965
377,86,102,9,63,2,9,24,185,161
378,80,554,35,113,0,7,78,709,631
379,56,919,0,505,99,30,45,1553,1508
380,18,96,1,42,12,3,32,154,122
381,51,5,2,16,3,2,19,28,9
382,71,2,0,6,8,6,5,22,17
383,71,6,4,9,6,36,35,61,26
384,80,23,1,25,0,8,7,57,50
385,2,610,105,125,137,42,21,1019,998
386,83,67,5,61,3,8,19,144,125
387,29,65,36,74,38,20,110,233,123
388,11,416,0,26,0,0,4,442,438
389,55,23,0,11,3,2,2,39,37
390,19,19,3,26,10,9,3,67,64
391,1,155,7,80,13,7,10,262,252
392,19,14,0,24,3,3,2,44,42
393,28,370,9,92,6,9,4,486,482
394,76,4,22,11,3,7,32,47,15
395,50,407,53,221,58,150,26,889,863
396,1,1200,0,204,38,29,14,1471,1457
397,90,85,44,54,102,78,6,363,357
398,83,583,34,309,0,22,125,948,823
399,73,483,0,591,156,0,12,1230,1218
400,24,2,5,9,28,6,28,50,22
401,11,966,26,282,52,26,26,1352,1326
402,33,822,114,108,179,137,114,1360,1246
403,4,604,0,100,19,0,28,723,695
404,14,19,3,19,3,1,3,45,42
405,30,5,3,11,12,5,9,36,27
406,75,2,2,2,2,1,1,9,8
407,26,1076,68,103,29,91,68,1367,1299
408,77,1285,42,716,55,0,21,2098,2077
409,8,10,0,7,2,0,1,19,18
410,42,551,137,792,179,103,33,1762,1729
411,28,800,0,297,0,34,57,1131,1074
412,52,2,2,11,10,6,12,31,19
413,1,378,0,189,97,172,172,836,664
414,1,1248,16,349,43,16,16,1672,1656
415,42,235,0,235,19,4,191,493,302
416,76,515,47,181,149,95,95,987,892
417,27,438,66,400,12,38,114,954,840
418,28,25,0,22,2,3,5,52,47
419,49,31,0,7,2,0,6,40,34
420,12,357,35,271,28,28,14,719,705
421,14,400,4,35,6,0,22,445,423
422,89,99,0,15,2,1,5,117,112
423,96,1,11,5,4,6,9,27,18
424,56,5,4,13,8,0,4,30,26
425,72,77,28,31,16,0,4,152,148
426,14,3,1,2,4,3,1,13,12
427,13,10,4,14,4,4,1,36,35
428,99,0,6,3,7,6,12,22,10
429,72,0,0,1,2,12,5,15,10
430,92,76,14,74,13,5,10,182,172
431,87,398,190,537,61,156,37,1342,1305
432,7,14,7,11,11,0,5,43,38
433,91,208,7,82,30,66,35,393,358
434,71,430,16,322,43,24,33,835,802
435,24,656,38,161,62,47,37,964,927
436,17,14,2,30,8,2,3,56,53
437,87,141,70,106,72,19,23,408,385
438,21,507,19,364,25,47,9,962,953
439,90,164,24,103,12,3,42,306,264
440,44,606,24,974,197,194,64,1995,1931
441,71,116,11,72,3,17,46,219,173
442,52,143,15,60,24,23,5,265,260
443,78,398,96,447,220,96,32,1257,1225
444,2,522,0,257,32,16,66,827,761
445,60,161,0,253,199,191,122,804,682
446,25,112,0,6,2,1,14,121,107
447,47,483,84,398,205,84,241,1254,1013
448,46,7,5,39,17,15,37,83,46
449,83,789,25,420,16,38,0,1288,1288
450,17,1239,17,413,23,34,17,1726,1709
451,13,4,1,5,2,0,3,12,9
452,86,335,42,127,28,5,5,537,532
453,92,639,8,166,11,8,58,832,774
454,47,563,76,384,84,192,89,1299,1210
455,18,2,0,8,2,2,3,14,11
456,81,746,8,125,11,8,8,898,890
457,91,22,1,13,4,0,4,40,36
458,58,4,1,6,4,1,9,16,7
459,40,478,0,193,110,75,117,856,739
460,67,20,3,4,2,0,2,29,27
461,19,451,0,39,0,4,24,494,470
462,93,371,22,39,6,0,92,438,346
463,41,281,7,84,15,0,119,387,268
464,60,19,7,19,0,1,24,46,22
465,54,26,3,13,2,10,0,54,54
466,26,138,15,35,25,11,72,224,152
467,30,213,2,44,0,2,5,261,256
468,93,407,28,100,120,74,18,729,711
469,35,483,74,114,169,37,18,877,859
470,4,738,0,232,13,20,50,1003,953
471,92,502,12,109,16,6,90,645,555
472,24,11,0,5,2,1,1,19,18
473,96,24,1,108,29,29,14,191,177
474,11,1170,19,594,99,76,134,1958,1824
475,99,185,2,88,15,5,14,295,281
476,72,983,20,389,240,50,40,1682,1642
477,77,691,0,69,10,0,130,770,640
478,85,504,13,131,8,0,26,656,630
479,88,317,25,265,25,19,12,651,639
480,22,29,1,9,2,0,2,41,39
481,83,1396,0,322,46,35,17,1799,1782
482,63,529,0,356,63,28,0,976,976
483,9,388,14,218,91,14,21,725,704
484,92,13,2,21,4,0,24,40,16
485,2,28,0,4,0,0,0,32,32
486,6,16,36,21,20,62,108,155,47
487,66,1047,0,140,67,38,153,1292,1139
488,49,31,0,7,2,0,6,40,34
489,29,815,10,239,28,10,108,1102,994
490,77,225,162,387,106,36,29,916,887
491,77,493,70,324,146,40,84,1073,989
492,71,34,4,66,3,10,20,117,97
493,49,382,138,65,60,26,59,671,612
494,97,127,1,56,0,1,31,185,154
495,6,325,83,300,86,58,91,852,761
496,93,238,17,68,8,10,6,341,335
497,78,1168,92,408,72,129,55,1869,1814
498,62,284,0,55,0,6,52,345,293
499,47,1288,20,613,80,61,27,2062,2035
500,9,65,0,46,4,3,20,118,98
501,77,11,7,9,3,1,11,31,20
502,24,227,23,389,42,21,75,702,627
503,19,1035,134,670,25,38,0,1902,1902
504,67,27,1,12,2,0,10,42,32
505,95,982,73,351,56,14,175,1476,1301
506,48,179,2,64,38,17,58,300,242
507,73,1379,33,216,0,33,66,1661,1595
508,35,32,1,64,16,12,85,125,40
509,76,8,4,15,7,6,2,40,38
510,20,881,38,319,16,25,12,1279,1267
511,72,141,15,153,67,31,35,407,372
512,20,1000,155,379,224,17,120,1775,1655
513,69,206,10,67,30,27,71,340,269
514,80,162,61,83,97,57,61,460,399
515,65,619,54,260,127,54,54,1114,1060
516,52,456,4,24,0,0,9,484,475
517,65,112,6,92,3,9,38,222,184
518,57,11,3,22,2,2,6,40,34
519,70,172,12,112,8,0,15,304,289
520,0,78,0,11,0,0,7,89,82
521,19,464,151,292,65,60,30,1032,1002
522,50,99,4,32,37,54,6,226,220
523,67,19,3,19,4,5,26,50,24
524,46,1,9,8,11,3,22,32,10
525,37,63,10,83,7,19,19,182,163
526,38,252,3,42,4,3,102,304,202
527,9,1478,19,403,0,19,0,1919,1919
528,56,198,18,252,32,108,54,608,554
529,98,8,4,10,6,7,6,35,29
530,68,416,46,925,60,107,46,1554,1508
531,72,42,7,43,20,12,10,124,114
532,47,14,3,21,2,1,28,41,13
533,33,17,0,3,0,0,1,20,19
534,87,15,4,10,3,4,18,36,18
535,0,6,16,24,11,0,34,57,23
536,73,458,0,24,6,4,34,492,458
537,74,30,3,47,19,21,42,120,78
538,4,179,28,520,111,123,47,961,914
539,50,90,17,97,15,6,15,225,210
540,57,308,85,137,102,45,118,677,559
541,30,557,129,761,29,185,111,1661,1550
542,27,7,4,13,15,8,17,47,30
543,61,1492,38,287,50,57,33,1924,1891
544,4,30,8,12,8,8,12,66,54
545,75,249,153,940,58,134,38,1534,1496
546,12,465,25,132,136,0,37,758,721
547,13,129,129,259,168,121,83,806,723
548,9,174,18,81,28,6,24,307,283
549,48,189,2,29,3,2,40,225,185
550,80,747,10,161,65,40,42,1023,981
551,60,6,0,2,2,0,1,10,9
552,43,14,0,3,0,0,4,17,13
553,19,12,0,4,0,0,1,16,15
554,26,98,0,106,49,10,106,263,157
555,58,32,0,5,0,0,1,37,36
556,42,51,12,49,17,24,24,153,129
557,27,200,5,44,0,10,20,259,239
558,56,25,6,25,6,0,0,62,62
559,27,1050,12,144,0,0,24,1206,1182
560,10,117,0,22,13,0,30,152,122
561,48,9,4,17,10,2,7,42,35
562,39,56,0,11,0,0,8,67,59
563,85,145,13,46,17,2,4,223,219
564,64,203,0,10,0,0,2,213,211
565,69,270,3,27,39,6,99,345,246
566,54,9,0,16,6,6,10,37,27
567,57,37,12,23,8,11,52,91,39
568,64,46,0,7,0,0,2,53,51
569,10,31,1,13,7,2,9,54,45
570,65,1060,21,530,32,0,224,1643,1419
571,74,264,47,188,54,47,11,600,589
572,4,399,4,30,6,4,30,443,413
573,94,8,9,9,2,5,22,33,11
574,41,19,0,35,6,4,17,64,47
575,25,817,183,797,106,163,20,2066,2046
576,94,292,127,635,132,127,165,1313,1148
577,9,12,6,2,11,2,16,33,17
578,47,130,30,168,20,34,0,382,382
579,12,6,4,16,3,10,30,39,9
580,80,16,12,18,7,1,13,54,41
581,20,19,0,9,0,0,2,28,26
582,39,4,7,15,13,9,15,48,33
583,57,31,3,31,2,8,4,75,71
584,27,36,0,2,0,0,4,38,34
585,83,526,28,135,10,21,99,720,621
586,79,400,32,519,71,75,54,1097,1043
587,69,410,16,114,0,5,49,545,496
588,77,80,3,26,4,2,14,115,101
589,15,88,10,46,2,3,64,149,85
590,99,55,0,6,2,0,4,63,59
591,61,5,1,13,3,5,1,27,26
592,23,8,4,5,15,2,11,34,23
593,84,410,0,592,147,22,22,1171,1149
594,74,101,13,76,20,18,40,228,188
595,90,162,25,53,16,0,10,256,246
596,41,2,8,1,4,7,15,22,7
597,28,25,0,8,2,0,2,35,33
598,73,389,91,248,64,49,41,841,800
599,88,215,13,87,17,17,24,349,325
600,94,27,0,5,0,0,3,32,29
601,31,5,6,10,6,5,10,32,22
602,6,179,8,83,19,11,26,300,274
603,23,352,0,27,10,0,15,389,374
604,92,17,8,12,11,15,32,63,31
605,52,625,35,169,58,17,35,904,869
606,50,10,6,11,0,4,2,31,29
607,54,390,22,323,104,35,107,874,767
608,93,10,2,15,2,1,6,30,24
609,56,215,63,507,231,31,190,1047,857
610,28,1001,17,572,93,125,17,1808,1791
611,94,19,18,33,24,1,8,95,87
612,76,41,5,129,10,3,3,188,185
613,43,1181,107,199,39,30,30,1556,1526
614,46,603,45,207,36,18,54,909,855
615,13,129,129,259,168,121,83,806,723
616,27,10,24,15,13,1,30,63,33
617,12,514,22,732,42,198,79,1508,1429
618,3,14,0,1,0,0,1,15,14
619,72,387,20,713,38,54,163,1212,1049
620,6,121,103,69,8,44,48,345,297
621,53,965,69,279,54,41,69,1408,1339
622,58,707,21,250,85,43,73,1106,1033
623,78,571,50,142,33,50,159,846,687
624,57,586,66,653,17,0,26,1322,1296
625,37,1063,89,102,16,12,25,1282,1257
626,20,305,3,27,4,3,144,342,198
627,73,1200,105,758,0,42,147,2105,1958
628,56,163,2,40,8,11,11,224,213
629,36,1009,181,104,202,21,207,1517,1310
630,9,125,6,73,8,4,19,216,197
631,42,721,0,152,119,50,50,1042,992
632,28,315,4,62,41,31,146,453,307
633,23,1000,19,711,125,115,38,1970,1932
634,38,16,0,17,6,3,6,42,36
635,63,757,80,217,29,80,11,1163,1152
636,71,30,2,25,0,1,9,58,49
637,9,219,3,100,26,0,17,348,331
638,87,111,3,28,2,6,15,150,135
639,92,45,47,52,21,20,25,185,160
640,36,410,112,420,0,82,71,1024,953
641,86,100,1,39,6,1,76,147,71
642,83,509,0,65,7,11,5,592,587
643,74,3,6,5,0,2,6,16,10
644,87,445,53,213,104,98,151,913,762
645,29,2,2,11,41,7,11,63,52
646,88,4,1,11,6,2,2,24,22
647,77,6,1,7,23,4,19,41,22
648,25,14,0,3,0,0,3,17,14
649,34,1,10,11,19,3,15,44,29
650,43,26,0,6,0,0,2,32,30
651,76,111,16,37,7,9,18,180,162
652,81,418,61,428,80,51,10,1038,1028
653,87,327,9,122,19,14,83,491,408
654,33,371,159,194,58,106,141,888,747
655,38,275,59,107,69,101,59,611,552
656,63,789,0,142,12,9,38,952,914
657,26,1,1,5,0,3,1,10,9
658,17,1004,12,145,32,12,36,1205,1169
659,75,187,81,149,25,43,91,485,394
660,13,56,4,76,17,1,18,154,136
661,19,365,32,117,34,110,6,658,652
662,51,595,23,123,10,23,154,774,620
663,81,1132,134,384,175,134,115,1959,1844
664,32,34,11,137,179,61,45,422,377
665,84,116,6,82,6,6,41,216,175
666,87,565,32,435,28,32,54,1092,1038
667,99,372,18,126,47,48,78,611,533
668,96,899,102,838,133,102,40,2074,2034
669,40,760,40,480,0,40,26,1320,1294
670,3,260,86,559,63,9,67,977,910
671,98,459,0,24,6,0,4,489,485
672,73,466,0,224,119,49,99,858,759
673,90,67,15,80,17,11,80,190,110
674,29,2,0,7,3,7,10,19,9
675,3,67,1,20,0,2,31,90,59
676,94,92,4,18,3,3,6,120,114
677,65,4,2,11,2,0,4,19,15
678,33,20,1,28,3,3,2,55,53
679,46,273,11,178,62,83,29,607,578
680,29,434,22,388,104,22,34,970,936
681,99,321,11,309,33,26,34,700,666
682,26,212,123,177,15,64,23,591,568
683,30,909,12,278,0,12,242,1211,969
684,27,1184,32,352,21,16,16,1605,1589
685,24,112,19,21,16,14,5,182,177
686,93,656,80,455,52,107,93,1350,1257
687,34,23,0,8,6,2,18,39,21
688,88,537,6,42,16,6,30,607,577
689,96,712,0,45,0,0,191,757,566
690,10,23,1,13,2,2,18,41,23
691,26,1,3,4,2,2,6,12,6
692,49,664,58,83,32,0,66,837,771
693,11,6,10,21,19,14,42,70,28
694,44,299,5,201,21,21,49,547,498
695,75,99,13,66,43,8,4,229,225
696,64,749,40,294,121,160,147,1364,1217
697,19,345,25,501,63,138,80,1072,992
698,45,9,4,18,7,5,5,43,38
699,77,440,81,368,0,122,174,1011,837
700,9,8,2,5,3,0,3,18,15
701,1,670,9,249,0,28,9,956,947
702,90,524,0,134,28,28,155,714,559
703,43,6,0,6,2,1,1,15,14
704,79,597,166,597,172,166,249,1698,1449
705,19,7,0,12,13,7,32,39,7
706,99,54,0,7,0,0,4,61,57
707,62,445,25,706,80,76,48,1332,1284
708,41,294,142,218,164,58,151,876,725
709,60,292,3,77,10,3,26,385,359
710,17,412,22,132,59,28,183,653,470
711,24,8,0,3,0,0,0,11,11
712,60,349,4,78,6,0,43,437,394
713,57,328,9,124,12,24,109,497,388
714,74,144,2,99,7,2,30,254,224
715,22,1126,28,211,37,28,42,1430,1388
716,46,967,0,617,43,50,0,1677,1677
717,69,432,79,341,177,136,170,1165,995
718,29,138,39,63,55,18,21,313,292
719,37,0,0,1,7,4,6,12,6
720,26,509,133,497,78,24,97,1241,1144
721,8,948,10,86,13,21,21,1078,1057
722,26,39,2,25,4,3,24,73,49
723,79,28,1,21,3,0,10,53,43
724,71,13,11,24,13,8,40,69,29
725,83,307,26,360,138,31,40,862,822
726,57,901,31,345,75,31,191,1383,1192
727,37,2,5,12,4,8,7,31,24
728,30,283,17,372,138,106,44,916,872
729,34,4,3,7,0,3,11,17,6
730,0,769,80,252,15,34,65,1150,1085
731,89,518,42,742,55,56,84,1413,1329
732,92,350,8,66,17,4,4,445,441
733,87,445,53,213,104,98,151,913,762
734,20,778,178,689,41,27,44,1713,1669
735,56,709,93,374,104,80,80,1360,1280
736,28,359,35,314,93,116,89,917,828
737,55,799,12,375,16,12,12,1214,1202
738,25,895,10,101,13,0,152,1019,867
739,0,40,2,23,0,4,23,69,46
740,86,76,0,7,0,0,16,83,67
741,8,11,5,22,12,5,11,55,44
742,33,245,16,223,21,43,16,548,532
743,13,647,107,391,175,67,40,1387,1347
744,12,39,1,9,2,1,34,52,18
745,92,203,35,305,46,17,227,606,379
746,90,138,3,38,4,0,59,183,124
747,8,587,51,898,247,0,86,1783,1697
748,6,595,97,291,127,133,121,1243,1122
749,91,43,12,23,29,15,61,122,61
750,52,301,7,74,10,0,58,392,334
751,3,180,32,348,76,32,90,668,578
752,57,794,115,243,150,0,205,1302,1097
753,9,392,5,91,28,26,112,542,430
754,22,39,1,22,3,4,12,69,57
755,76,107,2,12,2,2,12,125,113
756,86,13,0,3,0,0,0,16,16
757,64,70,0,17,0,0,6,87,81
758,90,680,11,392,75,0,0,1158,1158
759,79,26,1,11,0,1,4,39,35
760,28,522,0,522,227,120,134,1391,1257
761,86,412,12,546,78,182,0,1230,1230
762,42,6,5,5,8,0,5,24,19
763,39,2,3,6,4,1,9,16,7
764,8,1,3,8,2,5,5,19,14
765,40,6,2,15,6,6,3,35,32
766,5,4,12,5,3,16,17,40,23
767,96,18,2,19,0,2,6,41,35
768,28,324,48,186,39,18,198,615,417
769,22,327,9,125,25,4,139,490,351
770,30,229,27,71,13,3,34,343,309
771,45,521,168,706,80,76,61,1551,1490
772,58,184,23,446,30,23,23,706,683
773,49,4,8,11,12,2,13,37,24
774,37,183,2,64,7,2,12,258,246
775,70,31,19,35,26,14,52,125,73
776,33,219,3,60,12,9,12,303,291
777,98,479,28,136,75,14,35,732,697
778,17,584,44,212,46,8,177,894,717
779,54,627,91,597,159,91,15,1565,1550
780,39,24,1,16,12,2,5,55,50
781,81,330,5,159,36,27,16,557,541
782,71,19,1,10,2,1,8,33,25
783,62,28,23,29,29,14,47,123,76
784,8,606,148,228,15,148,22,1145,1123
785,76,1039,43,204,153,58,29,1497,1468
786,66,411,0,26,0,0,21,437,416
787,83,34,1,19,2,7,0,63,63
788,28,161,28,136,32,3,45,360,315
789,87,623,53,178,23,17,133,894,761
790,43,604,26,470,123,161,94,1384,1290
791,0,3,10,8,3,16,32,40,8
792,1,12,2,17,6,1,10,38,28
793,1,184,174,256,50,30,32,694,662
794,72,393,0,239,90,69,69,791,722
795,72,410,73,747,76,161,30,1467,1437
796,12,376,9,83,19,4,4,491,487
797,89,7,2,4,2,1,4,16,12
798,67,68,0,226,51,157,68,502,434
799,54,642,14,49,0,7,57,712,655
800,34,8,7,9,13,6,12,43,31
801,15,840,53,804,23,71,17,1791,1774
802,43,7,10,13,3,11,11,44,33
803,0,464,5,64,7,0,37,540,503
804,74,30,3,47,19,21,42,120,78
805,61,1492,38,287,50,57,33,1924,1891
806,51,752,122,476,39,153,34,1542,1508
807,97,1279,15,287,20,0,15,1601,1586
808,75,22,1,8,2,1,2,34,32
809,83,860,28,409,73,56,56,1426,1370
810,23,3,0,5,13,0,1,21,20
811,65,10,5,28,11,1,8,55,47
812,94,351,16,156,7,5,145,535,390
813,42,421,5,90,0,16,10,532,522
814,10,2,5,7,0,18,18,32,14
815,94,25,1,9,2,1,1,38,37
816,50,336,123,274,46,123,141,902,761
817,46,191,9,97,0,6,82,303,221
818,98,563,50,774,28,31,187,1446,1259
819,42,31,0,6,0,1,8,38,30
820,30,479,5,82,7,17,171,590,419
821,11,18,6,15,12,8,17,59,42
822,61,91,65,52,10,44,28,262,234
823,12,5,7,24,19,14,20,69,49
824,76,2,14,28,16,3,7,63,56
825,2,362,50,431,134,35,54,1012,958
826,43,724,74,929,97,55,130,1879,1749
827,27,605,91,399,0,45,205,1140,935
828,60,547,7,140,0,7,63,701,638
829,79,104,1,54,13,9,14,181,167
830,96,8,2,15,0,10,18,35,17
831,17,224,2,25,7,0,110,258,148
832,0,384,0,102,21,32,5,539,534
833,38,556,54,845,202,133,63,1790,1727
834,43,24,0,2,0,0,9,26,17
835,1,408,0,21,0,0,17,429,412
836,25,265,199,303,234,9,170,1010,840
837,2,34,0,7,0,0,0,41,41
838,66,374,64,116,84,25,64,663,599
839,49,27,2,10,0,0,1,39,38
840,5,600,20,350,29,30,33,1029,996
841,71,13,2,18,6,1,0,40,40
842,35,167,2,89,0,0,34,258,224
843,94,0,2,3,4,1,5,10,5
844,80,46,35,69,84,41,66,275,209
845,61,88,39,78,58,13,93,276,183
846,29,243,11,119,10,3,15,386,371
847,0,275,11,68,25,7,7,386,379
848,80,6,0,4,0,0,0,10,10
849,54,121,62,90,68,20,125,361,236
850,71,4,12,15,19,7,12,57,45
851,27,1308,0,396,23,0,0,1727,1727
852,61,515,47,267,62,66,38,957,919
853,55,4,0,16,17,4,4,41,37
854,35,48,13,57,24,15,25,157,132
855,34,562,58,168,43,16,142,847,705
856,95,769,22,500,210,143,33,1644,1611
857,64,379,4,93,12,9,98,497,399
858,30,29,12,59,19,1,36,120,84
859,12,387,68,569,89,45,68,1158,1090
860,96,12,23,38,30,18,7,121,114
861,16,6,10,12,3,15,40,46,6
862,16,27,1,14,4,1,21,47,26
863,78,9,1,5,0,0,1,15,14
864,83,22,0,19,6,5,3,52,49
865,96,899,102,838,133,102,40,2074,2034
866,67,889,55,685,168,92,129,1889,1760
867,87,189,2,55,0,5,12,251,239
868,34,48,0,2,0,0,5,50,45
869,46,230,14,156,82,24,58,506,448
870,7,852,60,207,78,36,48,1233,1185
871,73,35,3,20,4,1,20,63,43
872,54,205,20,47,23,2,56,297,241
873,93,255,31,446,40,56,175,828,653
874,52,0,0,1,8,3,2,12,10
875,53,437,8,206,160,49,42,860,818
876,81,825,8,53,11,0,242,897,655
877,8,316,58,161,76,51,135,662,527
878,97,756,138,354,160,169,61,1577,1516
879,50,194,55,134,15,0,3,398,395
880,38,7,17,18,6,10,26,58,32
881,61,183,33,493,59,103,57,871,814
882,46,171,0,11,0,1,20,183,163
883,73,243,101,405,29,40,40,818,778
884,19,181,21,69,39,3,96,313,217
885,10,151,7,89,0,7,28,254,226
886,94,494,92,391,194,11,241,1182,941
887,10,464,28,873,29,18,37,1412,1375
888,37,5,1,5,10,0,7,21,14
889,94,29,0,29,0,5,4,63,59
890,23,102,9,49,24,3,12,187,175
891,75,604,28,674,91,28,28,1425,1397
892,40,571,12,523,63,60,24,1229,1205
893,24,953,0,71,0,0,174,1024,850
894,11,63,3,67,8,9,28,150,122
895,29,770,29,890,250,27,24,1966,1942
896,51,398,61,265,138,61,53,923,870
897,86,741,19,154,50,9,28,973,945
898,9,1478,19,403,0,19,0,1919,1919
899,30,156,29,56,30,32,47,303,256
900,73,960,64,464,146,0,16,1634,1618
901,25,38,0,2,0,0,6,40,34
902,67,315,26,473,220,12,182,1046,864
903,67,15,20,25,2,7,26,69,43
904,58,19,6,20,0,5,12,50,38
905,82,812,99,431,237,149,33,1728,1695
906,98,73,28,217,10,24,115,352,237
907,93,372,23,384,250,12,108,1041,933
908,53,871,111,704,145,55,166,1886,1720
909,66,375,152,335,93,91,81,1046,965
910,6,760,80,466,17,13,80,1336,1256
911,42,471,0,510,99,21,12,1101,1089
912,78,31,9,27,16,9,33,92,59
913,29,819,0,72,12,0,63,903,840
914,82,1,4,3,8,9,7,25,18
915,92,203,35,305,46,17,227,606,379
916,78,26,0,15,2,1,2,44,42
917,54,354,21,311,167,75,32,928,896
918,45,1253,0,447,23,71,35,1794,1759
919,59,371,17,238,23,24,106,673,567
920,8,588,7,76,110,15,15,796,781
921,51,480,86,249,75,86,144,976,832
922,51,517,12,54,16,6,120,605,485
923,76,267,98,606,48,70,98,1089,991
924,62,1111,24,790,160,45,172,2130,1958
925,86,7,7,14,7,16,15,51,36
926,60,1166,0,48,0,0,36,1214,1178
927,56,261,42,144,55,48,133,550,417
928,83,135,25,51,23,25,46,259,213
929,92,6,2,18,2,8,14,36,22
930,31,711,28,142,49,18,47,948,901
931,80,11,0,13,2,4,11,30,19
932,39,42,0,17,0,0,18,59,41
933,20,79,7,58,6,3,18,153,135
934,53,20,6,43,19,5,38,93,55
935,84,30,0,8,2,0,14,40,26
936,50,20,2,23,3,1,4,49,45
937,96,115,27,44,4,146,139,336,197
938,94,263,5,233,69,41,83,611,528
939,25,69,2,15,2,2,6,90,84
940,48,267,3,30,4,0,57,304,247
941,65,561,85,171,25,123,114,965,851
942,69,492,0,37,7,0,42,536,494
943,12,14,7,9,6,16,12,52,40
944,84,80,4,46,0,17,2,147,145
945,47,97,12,84,13,10,15,216,201
946,87,197,107,227,7,59,131,597,466
947,35,693,21,925,31,24,84,1694,1610
948,47,43,2,27,0,9,12,81,69
949,48,14,0,2,0,0,7,16,9
950,46,186,36,234,86,72,48,614,566
951,27,434,137,400,45,137,45,1153,1108
952,37,59,0,11,4,2,5,76,71
953,8,16,5,30,8,7,26,66,40
954,29,230,35,75,63,57,31,460,429
955,85,829,138,430,60,92,15,1549,1534
956,2,318,8,407,150,35,8,918,910
957,66,1206,55,445,168,18,18,1892,1874
958,60,292,3,77,10,3,26,385,359
959,54,30,9,12,2,11,30,64,34
960,70,729,17,133,11,0,195,890,695
961,55,12,1,3,0,0,7,16,9
962,20,2,1,1,1,0,1,5,4
963,78,22,3,18,0,0,11,43,32
964,63,587,43,337,42,87,54,1096,1042
965,17,674,168,108,192,42,231,1184,953
966,43,284,3,84,4,7,23,382,359
967,13,1023,93,651,49,55,37,1871,1834
968,46,1394,22,708,89,91,182,2304,2122
969,65,311,26,640,180,37,121,1194,1073
970,1,27,0,12,0,1,5,40,35
971,6,1296,17,311,45,69,51,1738,1687
972,32,3,6,7,0,0,3,16,13
973,34,393,5,136,7,5,27,546,519
974,70,218,63,282,137,35,70,735,665
975,49,66,0,16,0,6,20,88,68
976,65,4,2,11,2,0,4,19,15
977,25,795,0,545,95,58,0,1493,1493
978,84,15,10,19,8,17,20,69,49
979,7,384,25,292,130,41,64,872,808
980,34,244,8,32,7,2,50,293,243
981,38,158,19,288,25,0,38,490,452
982,1,1285,21,449,106,20,20,1881,1861
983,25,349,16,144,28,5,182,542,360
984,25,4,12,11,3,13,15,43,28
985,50,223,2,31,0,2,39,258,219
986,46,157,43,127,68,56,37,451,414
987,96,397,46,288,20,38,70,789,719
988,57,901,31,345,75,31,191,1383,1192
989,47,14,3,21,2,1,28,41,13
990,52,10,0,3,0,0,4,13,9
991,30,1230,0,396,232,178,158,2036,1878
992,63,81,1,31,2,1,0,116,116
993,51,154,20,66,0,12,27,252,225
994,14,63,0,21,7,0,12,91,79
995,20,30,0,11,0,0,3,41,38
996,56,90,67,165,30,43,11,395,384
997,41,635,114,254,132,152,76,1287,1211
998,72,127,4,73,15,6,11,225,214
999,1,13,3,6,6,5,6,33,27
1000,27,18,42,24,15,20,18,119,101
1001,77,45,2,26,4,1,1,78,77
1002,87,38,1,24,0,0,0,63,63
1003,81,986,36,168,16,0,108,1206,1098
1004,51,61,0,3,0,0,7,64,57
1005,79,4,9,16,17,0,12,46,34
1006,11,201,53,172,116,77,83,619,536
1007,54,19,8,29,0,12,26,68,42
1008,93,4,8,11,19,12,26,54,28
1009,0,18,0,2,0,0,2,20,18
1010,54,806,80,161,120,11,33,1178,1145
1011,21,380,98,733,110,112,28,1433,1405
1012,58,576,172,961,125,115,19,1949,1930
1013,3,458,81,356,106,50,40,1051,1011
1014,99,5,10,13,3,8,16,39,23
1015,70,350,60,568,110,133,145,1221,1076
1016,65,39,33,130,41,26,44,269,225
1017,44,26,1,16,2,2,15,47,32
1018,6,68,0,16,0,0,8,84,76
1019,9,45,3,9,4,4,7,65,58
1020,95,359,0,134,13,26,123,532,409
1021,70,403,24,29,6,24,218,486,268
1022,92,34,1,14,0,0,5,49,44
1023,62,73,18,66,7,12,2,176,174
1024,85,292,30,415,63,33,200,833,633
1025,2,14,0,16,0,0,6,30,24
1026,0,80,1,37,0,1,3,119,116
1027,91,30,11,33,13,6,29,93,64
1028,3,463,96,333,168,53,10,1113,1103
1029,68,75,12,141,43,39,187,310,123
1030,98,538,13,91,17,6,26,665,639
1031,41,635,114,254,132,152,76,1287,1211
1032,16,8,0,3,0,0,1,11,10
1033,82,1315,22,780,145,0,178,2262,2084
1034,1,4,2,12,7,5,26,30,4
1035,64,12,0,13,2,0,10,27,17
1036,68,347,44,534,17,0,26,942,916
1037,98,192,5,53,0,5,15,255,240
1038,32,241,0,12,0,0,25,253,228
1039,87,631,28,491,30,14,56,1194,1138
1040,84,336,28,282,184,54,54,884,830
1041,3,1099,0,45,0,0,34,1144,1110
1042,34,743,19,181,12,0,200,955,755
1043,23,124,83,267,85,59,35,618,583
1044,37,15,0,8,4,2,20,29,9
1045,22,397,19,69,12,0,9,497,488
1046,19,10,4,4,3,3,14,24,10
1047,7,530,117,678,134,44,147,1503,1356
1048,52,1215,33,249,64,116,149,1677,1528
1049,91,3,2,7,0,4,2,16,14
1050,93,444,44,382,11,8,17,889,872
1051,78,26,0,15,2,1,2,44,42
1052,23,736,114,279,82,76,190,1287,1097
1053,83,473,21,176,19,21,56,710,654
1054,92,32,0,5,2,0,8,39,31
1055,4,288,10,30,4,10,125,342,217
1056,32,1050,178,555,77,138,118,1998,1880
1057,27,1001,44,107,58,44,44,1254,1210
1058,10,9,1,7,0,3,2,20,18
1059,9,234,14,77,19,10,42,354,312
1060,65,7,2,6,2,0,3,17,14
1061,68,251,108,334,65,92,117,850,733
1062,16,172,10,125,21,13,16,341,325
1063,12,565,42,548,64,83,99,1302,1203
1064,95,5,0,8,2,0,0,15,15
1065,16,918,57,842,99,38,133,1954,1821
1066,46,652,8,158,21,0,142,839,697
1067,3,4,1,7,2,1,2,15,13
1068,80,152,27,103,106,54,81,442,361
1069,77,8,0,9,2,1,3,20,17
1070,0,336,130,411,240,32,43,1149,1106
1071,62,938,19,843,25,95,38,1920,1882
1072,91,68,8,18,19,8,12,121,109
1073,24,227,23,389,42,21,75,702,627
1074,2,38,4,22,3,3,3,70,67
1075,22,105,0,9,2,1,4,117,113
1076,56,162,50,100,55,30,27,397,370
1077,54,574,8,216,21,16,33,835,802
1078,71,160,80,369,67,39,41,715,674
1079,38,6,0,5,0,0,1,11,10
1080,62,614,35,160,58,35,35,902,867
1081,78,897,161,430,186,161,27,1835,1808
1082,18,70,54,109,80,9,45,322,277
1083,95,120,19,206,25,19,54,389,335
1084,66,211,2,30,7,7,10,257,247
1085,28,11,0,16,7,6,21,40,19
1086,78,760,53,400,17,93,0,1323,1323
1087,13,53,0,8,0,0,2,61,59
1088,27,7,4,13,15,8,17,47,30
1089,17,391,32,70,21,32,16,546,530
1090,71,199,9,57,20,21,6,306,300
1091,79,516,56,449,86,33,16,1140,1124
1092,1,709,45,115,30,160,45,1059,1014
1093,78,12,0,4,0,0,0,16,16
1094,23,1000,19,711,125,115,38,1970,1932
1095,75,19,3,18,3,1,0,44,44
1096,70,1224,28,140,0,14,168,1406,1238
1097,10,16,2,18,3,0,24,39,15
1098,24,88,39,54,64,28,153,273,120
1099,47,2,23,11,8,6,46,50,4
1100,98,508,11,59,23,5,29,606,577
1101,4,381,28,215,84,28,21,736,715
1102,15,74,0,42,2,1,6,119,113
1103,67,146,0,93,7,13,73,259,186
1104,32,23,17,23,43,20,9,126,117
1105,40,110,5,137,26,23,29,301,272
1106,54,165,3,147,4,24,41,343,302
1107,78,957,47,494,82,47,95,1627,1532
1108,94,41,0,17,3,1,16,62,46
1109,51,1,3,4,2,3,11,13,2
1110,42,176,29,818,0,33,112,1056,944
1111,67,815,8,53,11,0,70,887,817
1112,87,6,1,2,2,0,4,11,7
1113,29,8,4,20,6,3,16,41,25
1114,89,717,42,864,219,30,84,1872,1788
1115,74,1067,138,750,0,19,39,1974,1935
1116,97,166,5,107,11,8,29,297,268
1117,63,29,4,34,2,4,4,73,69
1118,88,714,76,395,116,0,12,1301,1289
1119,34,8,4,10,2,2,4,26,22
1120,81,229,5,56,3,2,20,295,275
1121,65,320,48,133,39,72,48,612,564
1122,51,23,0,26,7,15,3,71,68
1123,76,1,5,8,4,8,20,26,6
1124,76,56,0,12,0,0,18,68,50
1125,84,508,124,249,50,38,134,969,835
1126,56,29,0,25,2,2,3,58,55
1127,31,46,7,59,2,4,27,118,91
1128,0,454,0,171,8,19,32,652,620
1129,91,350,3,39,0,0,19,392,373
1130,40,10,0,8,0,0,9,18,9
1131,59,735,40,183,52,20,30,1030,1000
1132,96,897,126,196,91,112,37,1422,1385
1133,61,5,2,3,3,0,5,13,8
1134,14,777,35,731,39,137,114,1719,1605
1135,16,162,6,37,6,13,13,224,211
1136,98,35,0,11,0,0,2,46,44
1137,11,342,9,112,19,14,19,496,477
1138,52,258,105,239,237,172,9,1011,1002
1139,19,658,80,483,123,13,13,1357,1344
1140,61,356,80,329,138,17,106,920,814
1141,73,213,5,28,7,7,41,260,219
1142,0,454,0,171,8,19,32,652,620
1143,74,457,4,29,0,0,9,490,481
1144,55,241,45,604,34,26,54,950,896
1145,48,210,0,6,0,0,2,216,214
1146,53,441,35,83,7,29,11,595,584
1147,13,19,13,18,10,7,8,67,59
1148,34,28,9,37,12,7,13,93,80
1149,54,476,75,162,29,151,97,893,796
1150,69,364,40,425,158,60,50,1047,997
1151,81,0,0,2,3,3,8,8,0
1152,99,0,6,3,7,6,12,22,10
1153,3,863,83,547,86,99,33,1678,1645
1154,61,349,7,35,0,0,47,391,344
1155,65,5,23,15,0,18,14,61,47
1156,93,184,2,19,8,8,4,221,217
1157,24,8,0,8,0,0,2,16,14
1158,8,277,21,64,62,21,25,445,420
1159,72,44,5,19,0,4,19,72,53
1160,29,1156,120,915,94,144,96,2429,2333
1161,33,373,14,83,6,9,19,485,466
1162,68,134,8,76,6,0,11,224,213
1163,55,1148,0,60,0,0,24,1208,1184
1164,76,6,12,3,21,6,40,48,8
1165,17,4,1,11,0,0,1,16,15
1166,94,5,4,8,2,0,5,19,14
1167,86,24,2,20,2,2,10,50,40
1168,25,899,0,101,0,0,20,1000,980
1169,22,108,1,28,13,1,4,151,147
1170,15,27,2,7,0,2,13,38,25
1171,35,816,66,549,216,66,99,1713,1614
1172,81,1298,0,70,37,14,42,1419,1377
1173,55,10,0,11,17,29,29,67,38
1174,94,87,13,34,10,6,10,150,140
1175,50,57,2,51,4,2,23,116,93
1176,64,635,15,100,20,7,131,777,646
1177,91,43,12,23,29,15,61,122,61
1178,11,964,34,137,15,0,11,1150,1139
1179,72,572,8,259,34,35,80,908,828
1180,6,341,142,113,259,151,66,1006,940
1181,0,63,6,57,13,13,22,152,130
1182,66,221,104,169,102,78,84,674,590
1183,42,140,3,29,4,5,14,181,167
1184,60,1,2,8,4,3,13,18,5
1185,64,291,10,689,84,10,0,1084,1084
1186,87,544,13,85,8,6,29,656,627
1187,96,684,100,801,21,66,0,1672,1672
1188,1,1,12,9,0,14,7,36,29
1189,54,35,0,4,0,0,10,39,29
1190,53,87,3,25,3,2,13,120,107
1191,96,309,3,24,4,3,20,343,323
1192,58,172,73,93,95,78,34,511,477
1193,12,625,38,242,50,34,76,989,913
1194,78,972,59,913,25,19,59,1988,1929
1195,64,157,6,39,6,13,75,221,146
1196,26,48,9,45,3,15,20,120,100
1197,8,279,83,88,32,14,34,496,462
1198,49,132,0,16,0,0,4,148,144
1199,56,919,0,505,99,30,45,1553,1508
1200,55,62,0,22,3,1,26,88,62
1201,25,1,45,3,4,6,42,59,17
1202,50,2,6,4,3,1,9,16,7
1203,84,408,61,109,48,122,41,748,707
1204,30,51,1,7,2,1,25,62,37
1205,81,62,1,16,3,2,6,84,78
1206,74,952,12,180,47,12,12,1203,1191
1207,76,618,15,106,20,7,45,766,721
1208,36,11,7,12,2,2,27,34,7
1209,64,318,3,17,4,7,56,349,293
1210,62,56,0,14,0,0,2,70,68
1211,53,110,5,59,7,1,7,182,175
1212,86,23,0,11,2,1,3,37,34
1213,15,27,5,8,8,3,12,51,39
1214,67,18,3,19,3,3,6,46,40
1215,47,18,0,9,0,1,11,28,17
1216,47,303,0,280,60,147,15,790,775
1217,81,97,1,19,2,0,11,119,108
1218,98,997,15,414,99,30,76,1555,1479
1219,56,5,4,13,8,0,4,30,26
1220,48,95,11,35,0,4,7,145,138
1221,18,1,6,2,3,6,3,18,15
1222,74,46,1,12,3,0,9,62,53
1223,68,411,106,147,54,115,66,833,767
1224,36,244,51,270,101,0,45,666,621
1225,90,152,9,121,12,12,45,306,261
1226,65,1,1,3,1,1,1,7,6
1227,63,10,17,18,8,26,40,79,39
1228,82,12,0,5,0,0,4,17,13
1229,63,5,0,4,0,0,1,9,8
1230,55,790,19,133,12,0,19,954,935
1231,64,882,29,514,38,29,44,1492,1448
1232,51,615,28,259,12,48,30,962,932
1233,97,1004,59,265,115,59,27,1502,1475
1234,92,133,27,421,13,195,71,789,718
1235,51,595,23,123,10,23,154,774,620
1236,72,293,0,87,4,11,23,395,372
1237,39,313,15,47,20,0,192,395,203
1238,49,151,81,86,168,91,64,577,513
1239,21,15,0,2,0,0,6,17,11
1240,91,736,63,946,219,189,126,2153,2027
1241,37,15,0,8,4,2,20,29,9
1242,98,982,17,672,23,34,51,1728,1677
1243,85,1142,51,415,90,69,37,1767,1730
1244,40,28,0,11,0,0,9,39,30
1245,2,46,0,12,0,2,23,60,37
1246,78,897,161,430,186,161,27,1835,1808
1247,41,489,6,152,8,6,132,661,529
1248,94,25,4,9,6,8,32,52,20
1249,10,145,1,33,2,1,1,182,181
1250,73,630,26,611,44,18,54,1329,1275
1251,22,760,38,104,50,9,38,961,923
1252,30,420,15,186,151,38,15,810,795
1253,21,125,17,52,3,19,30,216,186
1254,51,464,5,64,7,0,70,540,470
1255,97,6,6,29,12,15,8,68,60
1256,56,1090,12,96,16,12,60,1226,1166
1257,4,3,2,11,2,2,10,20,10
1258,77,24,0,27,8,30,10,89,79
1259,95,737,21,106,55,63,210,982,772
1260,36,254,6,71,4,0,27,335,308
1261,13,817,185,687,145,55,241,1889,1648
1262,90,620,54,239,99,98,119,1110,991
1263,49,13,4,20,0,0,1,37,36
1264,18,113,61,204,34,26,47,438,391
1265,89,7,23,78,133,49,144,290,146
1266,43,16,2,18,2,1,5,39,34
1267,82,462,0,24,6,0,4,492,488
1268,84,22,2,10,6,4,34,44,10
1269,80,968,147,842,137,42,210,2136,1926
1270,68,283,112,151,51,72,125,669,544
1271,12,1,2,5,6,0,3,14,11
1272,75,14,1,7,2,1,1,25,24
1273,10,30,5,24,6,3,8,68,60
1274,91,4,0,5,0,1,5,10,5
1275,21,52,0,9,0,0,1,61,60
1276,28,62,1,57,19,11,48,150,102
1277,97,20,2,14,3,0,10,39,29
1278,49,545,7,114,37,21,78,724,646
1279,14,558,79,622,207,175,95,1641,1546
1280,5,6,5,4,13,4,25,32,7
1281,62,1111,24,790,160,45,172,2130,1958
1282,83,4,6,8,6,3,10,27,17
1283,48,183,5,65,3,5,49,261,212
1284,94,546,72,376,94,145,72,1233,1161
1285,61,606,7,155,10,0,54,778,724
1286,70,266,6,51,8,6,64,337,273
1287,43,1142,29,249,38,29,14,1487,1473
1288,23,1074,0,69,0,0,46,1143,1097
1289,37,771,51,154,54,10,154,1040,886
1290,50,371,32,189,0,58,6,650,644
1291,78,556,14,717,210,0,43,1497,1454
1292,74,202,5,74,11,5,14,297,283
1293,14,209,162,209,41,162,37,783,746
1294,77,35,40,111,36,40,12,262,250
1295,39,37,0,17,0,0,3,54,51
1296,89,171,45,73,59,10,90,358,268
1297,62,12,2,20,3,2,5,39,34
1298,59,44,4,21,6,0,27,75,48
1299,68,20,2,9,4,6,20,41,21
1300,13,779,86,537,34,69,138,1505,1367
1301,37,170,6,97,24,12,88,309,221
1302,36,491,48,231,112,105,134,987,853
1303,28,173,8,107,7,2,176,297,121
1304,2,7,10,13,16,0,4,46,42
1305,17,1205,0,235,19,14,205,1473,1268
1306,86,10,7,25,6,3,7,51,44
1307,54,97,4,44,6,1,18,152,134
1308,2,67,11,26,4,3,262,111,-151
1309,3,345,53,528,98,75,97,1099,1002
1310,84,6,5,17,3,24,46,55,9
1311,8,73,57,100,71,15,0,316,316
1312,4,711,36,217,172,96,168,1232,1064
1313,57,774,70,118,182,187,93,1331,1238
1314,24,163,0,480,0,126,75,769,694
1315,51,82,33,54,71,30,41,270,229
1316,29,358,108,413,141,97,32,1117,1085
1317,13,66,2,40,4,3,14,115,101
1318,23,13,6,7,0,3,3,29,26
1319,36,139,13,78,20,13,36,263,227
1320,88,274,0,21,4,6,15,305,290
1321,2,262,6,61,0,10,102,339,237
1322,3,1099,0,45,0,0,34,1144,1110
1323,15,32,0,8,23,4,18,67,49
1324,58,2,4,2,0,11,5,19,14
1325,11,6,10,21,19,14,42,70,28
1326,27,6,7,4,3,4,6,24,18
1327,32,135,46,92,65,61,11,399,388
1328,12,641,7,84,0,30,38,762,724
1329,88,714,76,395,116,0,12,1301,1289
1330,91,794,73,573,0,29,14,1469,1455
1331,12,420,0,452,182,64,140,1118,978
1332,21,1,2,7,4,3,11,17,6
1333,23,86,12,75,33,15,6,221,215
1334,10,823,25,459,124,29,95,1460,1365
1335,35,231,161,215,171,30,53,808,755
1336,69,8,15,27,0,20,33,70,37
1337,68,182,17,259,77,70,29,605,576
1338,85,557,129,984,193,37,18,1900,1882
1339,34,79,1,31,4,4,12,119,107
1340,55,368,24,68,38,0,88,498,410
1341,10,6,4,14,8,8,22,40,18
1342,30,160,15,196,15,11,50,397,347
1343,36,488,21,238,56,108,28,911,883
1344,14,691,7,69,0,7,23,774,751
1345,79,543,10,205,160,143,82,1061,979
1346,52,254,7,108,20,0,26,389,363
1347,97,5,4,10,2,2,7,23,16
1348,24,112,19,21,16,14,5,182,177
1349,0,134,11,59,15,2,30,221,191
1350,96,143,6,52,11,8,17,220,203
1351,89,51,4,24,4,7,1,90,89
1352,94,27,0,5,0,0,3,32,29
1353,98,459,0,24,6,0,4,489,485
1354,72,689,8,167,11,8,88,883,795
1355,1,283,10,38,0,13,27,344,317
1356,26,347,0,35,4,3,7,389,382
1357,5,5,13,14,0,5,31,37,6
1358,22,280,0,18,0,0,24,298,274
1359,56,95,14,64,2,9,38,184,146
1360,74,84,10,34,11,10,28,149,121
1361,24,18,3,17,3,0,4,41,37
1362,9,992,24,694,51,19,119,1780,1661
1363,10,9,1,7,0,3,2,20,18
1364,35,19,1,17,2,0,2,39,37
1365,56,709,93,374,104,80,80,1360,1280
1366,7,158,0,76,13,7,71,254,183
1367,51,10,14,29,4,2,36,59,23
1368,17,25,1,13,0,0,3,39,36
1369,30,8,4,12,15,4,29,43,14
1370,21,14,0,6,0,0,0,20,20
1371,2,622,7,115,30,0,15,774,759
1372,85,11,0,3,0,0,1,14,13
1373,65,25,3,16,8,5,2,57,55
1374,64,635,15,100,20,7,131,777,646
1375,11,100,64,79,65,0,109,308,199
1376,92,201,2,43,3,5,35,254,219
1377,54,642,14,49,0,7,57,712,655
1378,4,97,1,41,6,2,41,147,106
1379,53,204,5,39,17,0,89,265,176
1380,39,513,7,133,46,14,14,713,699
1381,49,88,3,21,4,1,29,117,88
1382,70,172,12,112,8,0,15,304,289
1383,40,329,35,222,130,35,43,751,708
1384,40,296,13,104,11,13,17,437,420
1385,43,100,2,16,2,1,31,121,90
1386,17,422,7,238,69,46,15,782,767
1387,40,1218,16,272,104,0,80,1610,1530
1388,84,5,1,7,2,1,4,16,12
1389,25,507,93,520,242,40,26,1402,1376
1390,62,52,12,50,4,36,55,154,99
1391,83,191,56,139,51,8,100,445,345
1392,47,2,23,11,8,6,46,50,4
1393,45,68,28,39,16,30,41,181,140
1394,34,20,4,10,6,4,17,44,27
1395,3,20,3,16,0,4,1,43,42
1396,1,7,0,1,0,0,0,8,8
1397,18,279,172,74,38,8,246,571,325
1398,45,977,12,253,16,12,101,1270,1169
1399,81,30,1,8,0,0,3,39,36
1400,77,6,1,7,23,4,19,41,22
1401,23,3,18,26,11,8,12,66,54
1402,48,14,0,2,0,0,7,16,9
1403,61,10,1,7,0,0,1,18,17
1404,60,7,10,17,8,6,13,48,35
1405,75,33,87,64,175,16,74,375,301
1406,64,12,0,13,2,0,10,27,17
1407,54,2,3,10,11,2,10,28,18
1408,84,693,21,118,110,147,42,1089,1047
1409,75,9,3,15,2,3,2,32,30
1410,16,129,26,67,3,67,2,292,290
1411,79,16,2,11,3,0,16,32,16
1412,92,201,2,43,3,5,35,254,219
1413,16,5,4,5,4,2,10,20,10
1414,96,14,36,11,3,26,35,90,55
1415,30,29,12,59,19,1,36,120,84
1416,60,26,2,19,10,5,8,62,54
1417,11,9,1,4,3,2,3,19,16
1418,75,14,0,23,4,5,19,46,27
1419,36,972,19,595,180,26,138,1792,1654
1420,71,966,168,672,246,105,126,2157,2031
1421,88,99,27,102,28,48,6,304,298
1422,93,482,35,553,72,160,17,1302,1285
1423,93,714,8,99,11,0,47,832,785
1424,54,587,54,348,71,54,130,1114,984
1425,41,399,27,159,58,8,39,651,612
1426,46,56,10,92,19,7,25,184,159
1427,28,227,151,573,98,54,31,1103,1072
1428,40,703,102,601,0,58,43,1464,1421
1429,82,37,0,17,0,0,3,54,51
1430,38,167,13,180,86,13,70,459,389
1431,3,458,81,356,106,50,40,1051,1011
1432,87,91,3,52,2,1,31,149,118
1433,49,15,8,16,11,5,22,55,33
1434,16,1302,68,731,89,114,45,2304,2259
1435,65,153,64,123,116,64,14,520,506
1436,9,508,5,21,7,5,10,546,536
1437,24,290,59,177,77,5,29,608,579
1438,25,38,0,2,0,0,6,40,34
1439,43,2,13,6,7,5,11,33,22
1440,10,30,0,10,2,0,5,42,37
1441,29,386,23,95,54,41,196,599,403
1442,45,443,10,75,0,10,48,538,490
1443,57,901,31,345,75,31,191,1383,1192
1444,20,9,0,3,0,0,1,12,11
1445,29,846,84,352,91,56,42,1429,1387
1446,82,8,3,9,19,4,22,43,21
1447,68,72,7,58,13,1,24,151,127
1448,65,29,0,5,0,1,5,35,30
1449,99,169,24,553,188,0,144,934,790
1450,9,460,35,422,33,12,153,962,809
1451,20,69,8,26,12,7,12,122,110
1452,78,556,14,717,210,0,43,1497,1454
1453,26,73,0,13,0,1,0,87,87
1454,68,112,1,54,7,7,36,181,145
1455,79,944,0,60,0,0,30,1004,974
1456,25,265,199,303,234,9,170,1010,840
1457,83,526,28,135,10,21,99,720,621
1458,32,2,3,12,3,5,7,25,18
1459,49,2,4,9,10,5,16,30,14
1460,50,378,97,259,197,194,34,1125,1091
1461,84,553,25,142,65,67,8,852,844
1462,96,751,127,687,20,15,31,1600,1569
1463,56,406,0,30,0,0,8,436,428
1464,85,1449,89,161,69,35,107,1803,1696
1465,63,123,17,171,39,0,30,350,320
1466,17,267,42,309,55,42,21,715,694
1467,11,209,0,40,3,2,15,254,239
1468,62,1259,172,815,97,148,33,2491,2458
1469,48,344,35,178,15,23,17,595,578
1470,86,22,3,30,0,5,15,60,45
1471,73,247,161,295,210,85,47,998,951
1472,36,38,0,12,3,1,1,54,53
1473,34,896,10,101,13,10,34,1030,996
1474,16,931,56,253,91,98,14,1429,1415
1475,48,758,12,385,33,89,89,1277,1188
1476,61,216,9,57,20,9,125,311,186
1477,54,2,3,10,11,2,10,28,18
1478,56,244,15,108,4,15,50,386,336
1479,74,539,6,91,8,6,97,650,553
1480,35,1181,26,120,17,13,39,1357,1318
1481,65,750,8,125,11,8,26,902,876
1482,48,306,5,109,21,109,92,550,458
1483,88,350,104,189,197,151,57,991,934
1484,19,331,197,170,58,152,35,908,873
1485,21,620,16,165,0,24,82,825,743
1486,27,434,137,400,45,137,45,1153,1108
1487,86,57,0,27,0,0,36,84,48
1488,92,811,76,428,99,137,107,1551,1444
1489,1,423,42,706,73,197,197,1441,1244
1490,14,2,12,10,6,13,30,43,13
1491,74,60,51,87,6,20,51,224,173
1492,84,675,0,85,10,7,77,777,700
1493,4,30,8,12,8,8,12,66,54
1494,50,40,1,40,4,3,18,88,70
1495,2,3,17,26,20,1,39,67,28
1496,73,910,111,724,49,74,55,1868,1813
1497,21,252,98,827,219,70,196,1466,1270
1498,82,34,6,21,11,4,8,76,68
1499,14,19,3,19,3,1,3,45,42
1500,56,2,1,1,0,0,1,4,3
1501,20,490,0,184,10,28,21,712,691
1502,54,332,194,377,149,125,57,1177,1120
1503,77,53,8,17,13,0,21,91,70
1504,5,784,48,560,42,176,48,1610,1562
1505,65,7,11,3,10,4,20,35,15
1506,33,1171,43,219,19,14,47,1466,1419
1507,65,215,7,33,3,0,13,258,245
1508,41,674,62,134,0,26,8,896,888
1509,86,57,0,27,0,0,36,84,48
1510,92,5,36,7,0,10,45,58,13
1511,97,104,20,101,24,15,5,264,259
1512,91,9,0,7,2,0,4,18,14
1513,0,431,82,441,80,20,102,1054,952
1514,59,1000,0,76,0,0,10,1076,1066
1515,4,448,40,469,80,0,91,1037,946
1516,5,33,4,24,4,2,5,67,62
1517,48,505,72,270,36,27,54,910,856
1518,99,267,38,701,149,165,63,1320,1257
1519,81,14,0,3,0,0,1,17,16
1520,95,631,0,115,10,7,30,763,733
1521,43,65,4,16,0,4,11,89,78
1522,5,10,12,12,25,1,20,60,40
1523,50,51,4,50,12,1,49,118,69
1524,76,293,35,179,46,59,65,612,547
1525,46,11,1,2,2,1,6,17,11
1526,68,50,1,27,6,7,1,91,90
1527,33,173,26,255,35,71,81,560,479
1528,50,423,184,368,13,97,21,1085,1064
1529,85,292,30,415,63,33,200,833,633
1530,63,757,80,217,29,80,11,1163,1152
1531,89,12,1,6,0,1,5,20,15
1532,81,167,2,44,6,2,19,221,202
1533,77,3,1,3,8,0,5,15,10
1534,50,30,5,22,8,9,28,74,46
1535,10,532,88,168,69,44,133,901,768
1536,30,29,12,59,19,1,36,120,84
1537,66,411,0,26,0,0,21,437,416
1538,16,5,3,4,4,1,0,17,17
1539,12,71,99,278,185,121,38,754,716
1540,30,46,0,40,3,0,3,89,86
1541,8,268,11,88,15,3,22,385,363
1542,93,928,63,254,0,12,12,1257,1245
1543,14,459,15,171,142,23,31,810,779
1544,53,483,0,108,0,6,36,597,561
1545,26,733,9,180,12,19,66,953,887
1546,23,1006,22,115,59,68,45,1270,1225
1547,92,34,1,14,0,0,5,49,44
1548,29,1156,120,915,94,144,96,2429,2333
1549,41,7,4,23,7,0,11,41,30
1550,56,244,15,108,4,15,50,386,336
1551,19,233,0,23,0,0,12,256,244
1552,4,35,3,67,10,8,24,123,99
1553,89,1252,0,465,46,35,0,1798,1798
1554,71,34,4,66,3,10,20,117,97
1555,81,255,43,134,37,14,24,483,459
1556,31,8,1,5,0,0,1,14,13
1557,53,368,32,639,13,43,10,1095,1085
1558,78,255,47,573,52,32,15,959,944
1559,80,33,8,10,2,10,3,63,60
1560,18,163,23,424,27,65,76,702,626
1561,37,15,0,8,4,2,20,29,9
1562,52,45,12,52,25,22,13,156,143
1563,39,48,58,68,16,66,43,256,213
1564,11,158,6,45,8,2,2,219,217
1565,33,754,160,625,63,32,48,1634,1586
1566,22,108,1,28,13,1,4,151,147
1567,83,199,66,315,97,174,41,851,810
1568,43,2,7,5,2,15,27,31,4
1569,74,202,5,74,11,5,14,297,283
1570,54,85,0,3,0,0,7,88,81
1571,3,322,3,50,4,3,42,382,340
1572,96,18,2,19,0,2,6,41,35
1573,68,141,8,129,3,11,47,292,245
1574,2,739,107,309,140,80,35,1375,1340
1575,40,18,0,6,3,3,5,30,25
1576,64,378,0,88,19,4,73,489,416
1577,26,1083,108,649,253,151,108,2244,2136
1578,69,1016,12,215,16,12,63,1271,1208
1579,57,23,1,6,0,0,2,30,28
1580,78,12,1,21,2,2,3,38,35
1581,71,35,0,4,0,0,0,39,39
1582,59,548,31,422,0,112,28,1113,1085
1583,28,342,32,230,34,32,40,670,630
1584,61,365,3,15,4,3,11,390,379
1585,22,397,19,69,12,0,9,497,488
1586,95,456,19,832,75,118,38,1500,1462
1587,38,5,6,15,11,7,13,44,31
1588,19,836,185,575,24,25,77,1645,1568
1589,92,100,2,128,23,7,10,260,250
1590,24,10,0,10,3,1,7,24,17
1591,21,238,115,215,169,69,76,806,730
1592,35,6,0,5,2,1,2,14,12
1593,9,158,11,99,15,11,17,294,277
1594,23,86,12,75,33,15,6,221,215
1595,92,856,0,76,12,9,199,953,754
1596,55,98,1,17,0,1,5,117,112
1597,14,4,16,20,0,17,20,57,37
1598,78,398,96,447,220,96,32,1257,1225
1599,64,313,8,104,6,4,126,435,309
1600,49,109,18,16,24,26,18,193,175
1601,8,216,2,6,0,0,9,224,215
1602,35,595,71,153,120,112,41,1051,1010
1603,11,123,133,142,71,44,88,513,425
1604,8,16,0,23,3,2,10,44,34
1605,53,11,12,35,3,5,12,66,54
1606,36,410,112,420,0,82,71,1024,953
1607,64,159,2,51,6,2,24,220,196
1608,43,105,0,10,0,1,0,116,116
1609,40,5,1,8,0,0,1,14,13
1610,52,269,15,69,15,19,38,387,349
1611,11,629,0,70,0,0,35,699,664
1612,21,443,5,71,21,16,82,556,474
1613,23,217,77,373,111,23,93,801,708
1614,17,24,1,10,2,0,4,37,33
1615,6,9,1,5,4,5,7,24,17
1616,56,8,0,14,2,3,7,27,20
1617,71,1459,0,61,0,15,215,1535,1320
1618,51,230,48,214,13,32,75,537,462
1619,94,1,3,6,10,0,9,20,11
1620,27,340,21,134,258,14,56,767,711
1621,1,7,1,6,0,3,3,17,14
1622,56,298,7,68,4,0,19,377,358
1623,71,479,35,179,28,7,85,728,643
1624,18,267,140,599,34,12,127,1052,925
1625,48,67,4,32,17,2,16,122,106
1626,86,3,1,8,23,2,18,37,19
1627,48,980,37,265,35,163,31,1480,1449
1628,2,50,4,28,6,3,26,91,65
1629,57,19,0,5,0,0,8,24,16
1630,77,30,5,23,4,1,4,63,59
1631,0,213,9,76,4,3,30,305,275
1632,57,539,30,92,80,46,38,787,749
1633,24,284,16,160,84,16,134,560,426
1634,55,1003,34,536,134,51,34,1758,1724
1635,62,239,13,143,45,4,52,444,392
1636,89,51,23,82,33,0,42,189,147
1637,77,527,24,230,32,24,65,837,772
1638,45,19,5,12,10,3,19,49,30
1639,46,40,2,15,8,0,6,65,59
1640,80,21,8,20,15,3,9,67,58
1641,60,593,30,91,29,22,7,765,758
1642,71,21,5,3,10,1,7,40,33
1643,43,1181,107,199,39,30,30,1556,1526
1644,97,1004,59,265,115,59,27,1502,1475
1645,49,202,2,46,3,2,10,255,245
1646,66,446,107,768,33,196,53,1550,1497
1647,20,1184,102,673,52,40,40,2051,2011
1648,54,390,22,323,104,35,107,874,767
1649,61,726,53,363,123,107,161,1372,1211
1650,18,8,8,22,24,11,9,73,64
1651,45,50,15,110,39,15,15,229,214
1652,26,1,1,4,11,9,10,26,16
1653,0,308,0,73,0,0,23,381,358
1654,28,22,2,31,7,4,5,66,61
1655,49,690,117,499,76,102,88,1484,1396
1656,84,43,5,28,7,6,33,89,56
1657,38,27,0,10,0,0,4,37,33
1658,53,6,0,3,0,0,1,9,8
1659,88,205,7,41,3,2,46,258,212
1660,99,24,0,8,0,1,4,33,29
1661,12,667,50,850,21,83,83,1671,1588
1662,35,691,7,61,10,0,46,769,723
1663,5,493,26,206,116,80,80,921,841
1664,77,493,70,324,146,40,84,1073,989
1665,45,494,5,82,7,0,100,588,488
1666,71,621,73,414,78,48,85,1234,1149
1667,40,9,0,5,0,0,7,14,7
1668,82,1,6,2,8,2,12,19,7
1669,70,12,4,19,12,6,14,53,39
1670,87,243,131,217,85,6,26,682,656
1671,95,11,1,4,2,0,7,18,11
1672,72,532,21,127,26,20,20,726,706
1673,5,29,0,2,0,0,1,31,30
1674,86,612,91,520,258,107,107,1588,1481
1675,80,387,126,342,0,45,180,900,720
1676,62,56,0,14,0,0,2,70,68
1677,49,6,8,19,16,4,4,53,49
1678,85,582,0,65,0,0,13,647,634
1679,7,6,17,16,6,16,42,61,19
1680,6,70,6,69,2,3,3,150,147
1681,25,962,12,194,16,24,12,1208,1196
1682,55,112,10,107,30,0,20,259,239
1683,81,293,0,124,179,97,52,693,641
1684,98,199,12,31,3,12,7,257,250
1685,31,1060,61,835,80,20,101,2056,1955
1686,30,940,44,396,0,88,58,1468,1410
1687,98,44,2,11,2,3,7,62,55
1688,92,342,51,936,207,35,26,1571,1545
1689,41,2,10,11,12,9,20,44,24
1690,68,75,12,141,43,39,187,310,123
1691,78,520,20,367,39,81,40,1027,987
1692,46,5,3,9,6,2,6,25,19
1693,71,87,5,71,7,12,29,182,153
1694,6,462,61,184,10,53,107,770,663
1695,82,2,2,1,3,1,2,9,7
1696,71,979,44,935,29,25,22,2012,1990
1697,32,704,129,853,120,74,111,1880,1769
1698,28,861,31,558,62,95,79,1607,1528
1699,20,172,3,115,16,0,18,306,288
1700,10,5,7,31,15,4,7,62,55
1701,7,194,2,56,0,0,0,252,252
1702,67,9,7,13,3,2,20,34,14
1703,48,505,72,270,36,27,54,910,856
1704,61,533,10,217,198,174,195,1132,937
1705,36,48,0,14,0,0,6,62,56
1706,77,6,1,7,23,4,19,41,22
1707,90,18,2,10,0,0,25,30,5
1708,35,482,147,509,104,107,107,1349,1242
1709,38,204,97,97,21,118,26,537,511
1710,46,1073,0,250,153,14,14,1490,1476
1711,33,245,16,223,21,43,16,548,532
1712,70,560,21,442,29,44,29,1096,1067
1713,51,173,13,131,32,3,6,352,346
1714,18,22,1,11,0,5,3,39,36
1715,97,136,1,12,0,3,32,152,120
1716,32,275,0,86,10,23,66,394,328
1717,9,56,19,29,2,14,25,120,95
1718,6,303,23,751,82,26,191,1185,994
1719,80,708,7,62,0,0,15,777,762
1720,74,324,132,693,27,118,88,1294,1206
1721,49,1,5,3,7,4,8,20,12
1722,21,620,26,195,34,17,141,892,751
1723,95,312,21,206,102,92,149,733,584
1724,56,1493,86,454,112,43,43,2188,2145
1725,48,918,21,118,13,10,21,1080,1059
1726,26,98,0,106,49,10,106,263,157
1727,3,3,4,7,15,8,11,37,26
1728,39,380,0,47,6,0,34,433,399
1729,33,15,0,12,7,3,7,37,30
1730,42,3,9,4,7,8,7,31,24
1731,80,24,2,23,0,8,24,57,33
1732,9,80,1,60,4,6,16,151,135
1733,52,31,0,6,2,1,5,40,35
1734,78,138,120,204,16,126,60,604,544
1735,68,166,75,96,119,107,59,563,504
1736,45,12,3,8,8,0,17,31,14
1737,47,178,3,85,71,66,58,403,345
1738,34,707,20,171,65,60,50,1023,973
1739,81,5,1,7,17,14,11,44,33
1740,72,465,71,250,93,35,62,914,852
1741,23,16,1,2,0,0,1,19,18
1742,29,358,108,413,141,97,32,1117,1085
1743,80,1,9,7,2,14,10,33,23
1744,30,123,1,26,2,0,72,152,80
1745,15,40,3,30,10,7,11,90,79
1746,86,102,9,63,2,9,24,185,161
1747,68,347,44,534,17,0,26,942,916
1748,54,376,53,462,168,53,53,1112,1059
1749,44,21,0,3,0,0,0,24,24
1750,7,194,2,56,0,0,0,252,252
1751,87,64,4,68,7,5,17,148,131
1752,59,206,0,46,3,2,12,257,245
1753,16,71,0,18,0,0,13,89,76
1754,1,71,22,112,138,89,29,432,403
1755,64,0,4,7,11,10,15,32,17
1756,72,93,1,21,0,4,25,119,94
1757,98,920,138,168,36,46,30,1308,1278
1758,91,653,17,170,34,26,17,900,883
1759,8,199,33,60,8,3,15,303,288
1760,20,153,4,56,0,9,31,222,191
1761,6,376,0,38,11,8,69,433,364
1762,54,46,0,30,12,1,30,89,59
1763,72,600,21,128,223,150,128,1122,994
1764,46,425,115,292,23,35,79,890,811
1765,11,18,6,15,12,8,17,59,42
1766,21,52,0,9,0,0,1,61,60
1767,89,734,22,350,151,25,100,1282,1182
1768,82,34,6,21,11,4,8,76,68
1769,69,135,1,41,10,1,67,188,121
1770,55,11,0,10,0,2,20,23,3
1771,13,163,48,90,0,45,52,346,294
1772,80,29,3,30,3,2,9,67,58
1773,97,734,26,70,11,44,17,885,868
1774,27,340,21,134,258,14,56,767,711
1775,99,453,38,279,188,38,183,996,813
1776,87,1073,0,629,145,37,37,1884,1847
1777,85,135,0,10,0,4,36,149,113
1778,30,231,7,137,4,15,39,394,355
1779,82,18,0,5,0,0,11,23,12
1780,21,620,16,165,0,24,82,825,743
1781,92,81,4,33,5,2,291,125,-166
1782,95,12,4,2,10,6,10,34,24
1783,2,292,51,981,224,23,17,1571,1554
1784,74,965,34,586,89,86,37,1760,1723
1785,49,27,2,10,0,0,1,39,38
1786,71,777,30,163,0,51,122,1021,899
1787,72,572,8,232,23,62,17,897,880
1788,68,438,169,565,91,169,70,1432,1362
1789,4,531,69,300,150,138,150,1188,1038
1790,80,17,0,9,0,0,1,26,25
1791,15,402,35,106,101,77,42,721,679
1792,70,503,27,419,90,139,153,1178,1025
1793,91,369,9,87,12,14,34,491,457
1794,10,5,0,3,0,0,1,8,7
1795,99,362,17,398,80,35,61,892,831
1796,25,56,0,9,0,0,3,65,62
1797,34,79,1,31,4,4,12,119,107
1798,57,387,84,141,73,35,162,720,558
1799,84,367,17,241,104,188,232,917,685
1800,51,15,0,11,0,2,9,28,19
1801,97,267,6,54,8,3,50,338,288
1802,13,298,27,697,216,24,166,1262,1096
1803,92,674,92,736,39,0,92,1541,1449
1804,30,16,14,36,37,22,48,125,77
1805,30,37,4,24,16,9,9,90,81
1806,11,159,0,22,2,1,31,184,153
1807,72,686,17,142,23,26,35,894,859
1808,39,97,3,66,12,7,34,185,151
1809,0,63,6,57,13,13,22,152,130
1810,15,56,5,24,4,0,3,89,86
1811,12,209,19,456,160,142,66,986,920
1812,56,198,2,43,0,12,20,255,235
1813,39,313,15,47,20,0,192,395,203
1814,55,941,14,397,76,58,176,1486,1310
1815,60,86,4,56,2,4,7,152,145
1816,73,167,48,602,63,72,72,952,880
1817,90,8,3,19,0,2,3,32,29
1818,86,389,66,408,37,57,85,957,872
1819,37,239,7,119,4,15,11,384,373
1820,7,179,21,273,0,21,63,494,431
1821,29,5,0,1,1,1,1,8,7
1822,19,2,6,28,13,4,16,53,37
1823,14,383,0,53,6,4,40,446,406
1824,72,2,8,8,6,1,9,25,16
1825,56,536,27,590,38,107,67,1298,1231
1826,85,2,1,4,3,1,2,11,9
1827,62,322,53,899,34,40,53,1348,1295
1828,1,539,169,816,20,0,30,1544,1514
1829,28,712,50,420,65,38,38,1285,1247
1830,70,1121,0,72,0,12,12,1205,1193
1831,84,68,1,13,3,5,13,90,77
1832,89,36,4,18,6,2,18,66,48
1833,73,707,44,603,95,58,29,1507,1478
1834,42,174,77,203,6,24,97,484,387
1835,16,666,35,124,69,8,26,902,876
1836,16,0,0,0,6,2,6,8,2
1837,56,162,50,100,55,30,27,397,370
1838,65,407,70,239,103,88,53,907,854
1839,10,823,25,459,124,29,95,1460,1365
1840,13,488,23,71,15,0,59,597,538
1841,78,28,0,13,4,2,8,47,39
1842,51,3,2,10,3,0,2,18,16
1843,27,284,0,52,8,3,20,347,327
1844,30,938,142,754,159,81,183,2074,1891
1845,71,13,2,15,2,2,8,34,26
1846,97,412,172,153,150,105,57,992,935
1847,83,31,1,8,0,0,8,40,32
1848,3,502,19,132,0,6,26,659,633
1849,71,18,10,3,3,5,0,39,39
1850,3,1,8,6,4,8,16,27,11
1851,15,100,71,243,108,94,219,616,397
1852,52,407,114,445,181,165,203,1312,1109
1853,8,664,9,240,50,19,57,982,925
1854,89,1045,61,338,60,46,46,1550,1504
1855,66,1218,107,304,23,143,33,1795,1762
1856,22,15,0,6,0,1,12,22,10
1857,56,128,0,16,0,1,4,145,141
1858,74,581,49,157,43,8,108,838,730
1859,48,6,3,12,6,1,0,28,28
1860,67,185,8,133,56,56,12,438,426
1861,24,22,1,9,0,0,14,32,18
1862,67,584,100,835,65,83,35,1667,1632
1863,38,355,30,177,90,138,30,790,760
1864,86,175,10,110,54,6,27,355,328
1865,90,864,134,768,150,38,172,1954,1782
1866,87,957,153,612,99,95,153,1916,1763
1867,62,25,6,16,20,0,5,67,62
1868,23,641,7,56,0,0,28,704,676
1869,99,273,86,208,177,14,43,758,715
1870,29,122,21,43,25,10,15,221,206
1871,52,1,4,10,29,0,36,44,8
1872,90,1020,31,430,62,63,79,1606,1527
1873,9,6,2,3,1,262,3,274,271
1874,71,378,14,68,19,14,14,493,479
1875,13,42,1,18,3,0,4,64,60
1876,16,15,5,14,0,4,11,38,27
1877,94,272,7,80,20,7,11,386,375
1878,77,9,1,24,2,1,2,37,35
1879,20,279,0,18,0,0,9,297,288
1880,51,398,61,265,138,61,53,923,870
1881,81,637,47,237,12,19,76,952,876
1882,71,45,0,16,2,1,6,64,58
1883,36,21,1,9,7,3,5,41,36
1884,95,15,4,13,0,0,19,32,13
1885,32,493,183,352,184,23,28,1235,1207
1886,32,957,40,175,158,53,107,1383,1276
1887,85,829,138,430,60,92,15,1549,1534
1888,93,1017,50,500,65,50,133,1682,1549
1889,24,953,0,71,0,0,174,1024,850
1890,44,159,0,120,0,0,137,279,142
1891,15,32,0,8,23,4,18,67,49
1892,82,23,0,15,0,2,7,40,33
1893,27,18,42,24,15,20,18,119,101
1894,72,15,0,4,0,0,2,19,17
1895,7,23,4,5,10,5,23,47,24
1896,57,200,193,100,46,185,185,724,539
1897,84,1324,27,119,71,108,27,1649,1622
1898,53,1193,33,281,129,66,33,1702,1669
1899,48,505,137,401,104,22,22,1169,1147
1900,2,2,4,9,0,4,5,19,14
1901,65,1103,0,45,0,0,34,1148,1114
1902,45,353,61,753,40,46,27,1253,1226
1903,42,652,48,350,94,84,108,1228,1120
1904,29,379,6,157,25,91,91,658,567
1905,83,46,4,36,2,2,1,90,89
1906,93,162,31,127,8,17,69,345,276
1907,40,8,3,19,3,3,8,36,28
1908,47,17,3,18,3,4,18,45,27
1909,50,340,108,185,130,38,100,801,701
1910,40,8,4,15,3,5,3,35,32
1911,3,154,22,202,39,30,8,447,439
1912,62,710,15,30,20,0,0,775,775
1913,25,8,2,4,0,0,1,14,13
1914,48,2,2,4,13,13,4,34,30
1915,56,1050,14,322,0,14,112,1400,1288
1916,68,19,1,14,3,2,4,39,35
1917,64,22,0,6,6,2,6,36,30
1918,67,274,83,216,151,141,224,865,641
1919,94,68,6,38,3,6,41,121,80
1920,82,344,45,654,104,11,114,1158,1044
1921,3,145,193,459,205,26,145,1028,883
1922,24,217,38,350,111,85,15,801,786
1923,54,18,7,34,10,2,3,71,68
1924,20,69,8,26,12,7,12,122,110
1925,96,144,0,7,0,0,6,151,145
1926,19,256,34,103,90,29,49,512,463
1927,60,483,72,567,94,12,108,1228,1120
1928,2,1285,105,653,28,21,0,2092,2092
1929,13,338,4,89,11,8,13,450,437
1930,37,605,10,345,84,54,32,1098,1066
1931,59,8,0,7,3,1,1,19,18
1932,55,172,41,86,45,6,27,350,323
1933,60,448,71,951,40,17,17,1527,1510
1934,48,67,4,32,17,2,16,122,106
1935,38,512,53,98,81,179,89,923,834
1936,8,1462,16,128,0,0,160,1606,1446
1937,19,20,0,14,7,3,1,44,43
1938,32,50,4,44,10,10,43,118,75
1939,27,102,1,15,2,0,24,120,96
1940,58,499,149,815,173,49,49,1685,1636
1941,59,381,35,172,56,86,93,730,637
1942,29,631,43,239,128,76,21,1117,1096
1943,60,526,80,553,123,94,53,1376,1323
1944,41,913,26,376,17,26,13,1358,1345
1945,27,673,0,199,37,47,26,956,930
1946,28,23,0,9,0,0,12,32,20
1947,8,199,33,60,8,3,15,303,288
1948,18,261,23,73,4,23,50,384,334
1949,76,111,16,37,7,9,18,180,162
1950,0,16,4,12,2,4,321,38,-283
1951,32,63,151,137,153,19,53,523,470
1952,2,58,0,18,2,0,10,78,68
1953,16,29,1,17,0,3,13,50,37
1954,56,3,2,12,0,1,9,18,9
1955,97,28,34,62,11,14,44,149,105
1956,15,40,3,30,10,7,11,90,79
1957,35,879,143,797,106,143,143,2068,1925
1958,3,62,1,44,6,5,22,118,96
1959,49,280,7,81,20,0,27,388,361
1960,4,9,0,6,3,1,3,19,16
1961,45,182,4,33,0,2,42,221,179
1962,37,83,2,101,64,26,117,276,159
1963,39,38,15,54,3,8,29,118,89
1964,38,228,19,130,4,11,51,392,341
1965,8,1092,37,592,145,37,55,1903,1848
1966,89,85,15,27,13,13,21,153,132
1967,47,1276,24,746,94,29,48,2169,2121
1968,75,1017,33,417,108,100,16,1675,1659
1969,86,6,2,9,2,1,5,20,15
1970,4,448,21,125,52,101,62,747,685
1971,73,504,23,117,179,28,44,851,807
1972,46,226,22,133,41,31,31,453,422
1973,38,239,3,141,0,7,23,390,367
1974,73,90,38,67,33,36,67,264,197
1975,66,7,2,8,3,2,3,22,19
1976,36,4,2,5,2,0,0,13,13
1977,29,16,17,19,20,21,22,93,71
1978,29,10,3,3,0,0,0,16,16
1979,6,68,0,16,0,0,8,84,76
1980,97,35,0,13,2,0,2,50,48
1981,61,575,80,428,208,93,80,1384,1304
1982,68,315,0,31,4,0,91,350,259
1983,73,182,2,49,17,13,20,263,243
1984,90,561,14,113,10,14,35,712,677
1985,81,587,51,932,180,34,86,1784,1698
1986,1,94,1,33,13,12,12,153,141
1987,79,908,43,735,40,194,21,1920,1899
1988,92,228,122,122,208,129,30,809,779
1989,31,995,112,417,42,48,41,1614,1573
1990,46,11,1,2,2,1,6,17,11
1991,14,3,3,14,15,21,10,56,46
1992,89,12,1,16,4,1,3,34,31
1993,31,17,0,2,0,0,2,19,17
1994,75,8,0,5,0,3,6,16,10
1995,42,22,4,17,12,10,13,65,52
1996,53,14,10,29,4,7,15,64,49
1997,53,106,27,68,52,7,5,260,255
1998,23,820,57,242,45,0,11,1164,1153
1999,57,753,43,226,69,10,204,1101,897
2000,49,13,3,17,7,3,3,43,40
2001,6,9,1,3,0,4,8,17,9
2002,29,19,3,6,4,2,12,34,22
2003,5,520,8,223,32,49,42,832,790
2004,98,5,17,17,13,14,34,66,32
2005,80,618,44,215,0,17,36,894,858
2006,4,315,35,322,46,7,143,725,582
2007,70,15,1,23,0,5,1,44,43
2008,32,384,60,364,119,101,232,1028,796
2009,82,110,29,92,28,10,145,269,124
2010,27,208,17,76,36,17,38,354,316
2011,94,555,82,257,93,61,61,1048,987
2012,23,240,90,216,63,6,24,615,591
2013,97,11,0,36,15,5,12,67,55
2014,25,848,154,323,201,61,78,1587,1509
2015,92,202,47,197,55,42,149,543,394
2016,98,433,89,650,16,102,102,1290,1188
2017,19,6,6,15,10,5,2,42,40
2018,80,37,0,7,3,0,3,47,44
2019,80,167,37,64,49,34,116,351,235
2020,79,45,7,99,4,25,43,180,137
2021,50,129,0,21,0,1,7,151,144
2022,60,713,0,264,120,80,34,1177,1143
2023,44,676,161,426,210,44,58,1517,1459
2024,0,450,26,535,73,98,26,1182,1156
2025,28,22,2,12,0,2,5,38,33
2026,35,367,4,51,6,4,95,432,337
2027,49,526,35,214,69,53,35,897,862
2028,46,51,0,16,0,0,4,67,63
2029,97,25,0,11,3,0,15,39,24
2030,51,28,6,27,12,17,39,90,51
2031,80,958,159,447,20,0,31,1584,1553
2032,10,532,88,168,69,44,133,901,768
2033,29,724,17,143,0,8,196,892,696
2034,74,39,0,56,20,8,14,123,109
2035,54,587,54,348,71,54,130,1114,984
2036,93,29,1,11,0,0,0,41,41
2037,63,757,80,217,29,80,11,1163,1152
2038,92,544,35,133,23,151,107,886,779
2039,40,40,15,15,17,6,7,93,86
2040,70,1245,33,332,21,33,16,1664,1648
2041,96,19,1,20,16,14,28,70,42
2042,81,16,3,15,2,1,11,37,26
2043,63,376,4,94,12,9,24,495,471
2044,85,184,178,178,103,39,33,682,649
2045,51,15,0,11,0,2,9,28,19
2046,23,124,83,267,85,59,35,618,583
2047,95,627,120,414,121,80,93,1362,1269
2048,11,180,60,241,13,54,54,548,494
2049,42,14,0,4,0,0,8,18,10
2050,77,3,3,24,34,7,31,71,40
2051,40,8,26,46,38,9,49,127,78
2052,32,293,6,23,13,6,92,341,249
2053,48,758,12,385,33,89,89,1277,1188
2054,24,656,38,161,62,47,37,964,927
2055,61,196,25,607,67,17,49,912,863
2056,6,835,73,380,114,73,43,1475,1432
2057,16,16,11,15,2,0,12,44,32
2058,39,9,1,5,2,1,4,18,14
2059,2,229,7,140,10,3,11,389,378
2060,49,0,1,4,15,1,5,21,16
2061,31,121,24,124,24,15,42,308,266
2062,58,471,102,125,212,61,245,971,726
2063,5,520,8,223,32,49,42,832,790
2064,90,26,1,10,2,0,1,39,38
2065,47,240,132,445,250,192,108,1259,1151
2066,25,178,4,26,8,4,44,220,176
2067,60,1486,55,278,49,0,185,1868,1683
2068,67,1115,12,128,33,12,76,1300,1224
2069,40,29,0,8,2,0,6,39,33
2070,63,529,0,356,63,28,0,976,976
2071,1,13,3,8,7,4,16,35,19
2072,89,934,24,230,16,24,36,1228,1192
2073,40,2,7,11,16,12,27,48,21
2074,5,4,12,5,3,16,17,40,23
2075,3,62,1,44,6,5,22,118,96
2076,1,158,35,179,0,0,125,372,247
2077,24,173,2,39,3,2,47,219,172
2078,89,830,59,968,51,79,19,1987,1968
2079,48,189,10,253,56,43,64,551,487
2080,31,728,17,133,11,8,124,897,773
2081,68,7,2,9,2,0,2,20,18
2082,46,35,4,17,7,6,64,69,5
2083,92,188,3,180,20,3,43,394,351
2084,80,742,28,152,25,9,57,956,899
2085,16,0,7,5,26,2,17,40,23
2086,50,750,71,174,13,10,20,1018,998
2087,93,816,42,450,55,56,154,1419,1265
2088,51,5,2,8,2,2,9,19,10
2089,24,37,5,56,12,8,5,118,113
2090,79,4,0,4,0,0,5,8,3
2091,26,99,2,11,4,0,16,116,100
2092,86,176,72,98,136,21,229,503,274
2093,68,54,0,10,0,0,2,64,62
2094,98,997,15,414,99,30,76,1555,1479
2095,34,356,0,107,19,9,117,491,374
2096,60,1311,0,359,46,89,17,1805,1788
2097,3,890,63,292,0,25,12,1270,1258
2098,65,4,0,2,0,0,2,6,4
2099,83,17,0,14,7,3,2,41,39
2100,64,960,0,883,50,38,0,1931,1931
2101,69,1,3,2,20,30,47,56,9
2102,48,240,67,500,199,0,163,1006,843
2103,21,301,11,61,4,7,11,384,373
2104,30,154,0,50,6,11,37,221,184
2105,39,2,3,6,4,1,9,16,7
2106,76,104,12,48,4,12,5,180,175
2107,11,70,3,37,4,2,64,116,52
2108,26,2,0,9,3,6,2,20,18
2109,34,23,2,11,3,1,4,40,36
2110,72,43,4,12,8,0,27,67,40
2111,13,4,24,11,16,1,25,56,31
2112,58,654,7,92,0,15,30,768,738
2113,12,912,72,170,47,36,97,1237,1140
2114,23,25,0,8,0,1,4,34,30
2115,33,24,4,22,0,2,9,52,43
2116,30,141,11,114,15,14,5,295,290
2117,15,71,0,13,3,1,0,88,88
2118,25,35,1,16,0,1,1,53,52
2119,4,496,32,849,229,48,128,1654,1526
2120,80,9,9,11,13,10,16,52,36
2121,30,154,0,50,6,11,37,221,184
2122,6,9,1,5,4,5,7,24,17
2123,16,26,3,23,4,7,3,63,60
2124,57,77,8,44,10,10,25,149,124
2125,9,11,2,7,4,2,2,26,24
2126,59,576,7,115,19,7,7,724,717
2127,78,89,15,89,34,42,5,269,264
2128,90,1013,30,399,60,46,153,1548,1395
2129,74,224,12,48,4,12,12,300,288
2130,10,200,19,111,50,15,19,395,376
2131,63,570,73,614,133,102,73,1492,1419
2132,13,1,3,3,8,1,13,16,3
2133,98,62,1,20,4,0,7,87,80
2134,4,531,69,300,150,138,150,1188,1038
2135,94,162,28,818,0,28,56,1036,980
2136,91,675,144,133,94,192,241,1238,997
2137,66,23,4,10,0,2,15,39,24
2138,14,492,5,32,13,5,21,547,526
2139,77,918,10,129,13,0,129,1070,941
2140,41,224,155,155,192,93,54,819,765
2141,21,572,19,286,50,38,248,965,717
2142,25,626,0,70,0,7,28,703,675
2143,2,1074,37,518,193,92,129,1914,1785
2144,51,741,68,689,224,68,103,1790,1687
2145,3,322,3,50,4,3,42,382,340
2146,32,254,10,44,30,10,227,348,121
2147,84,116,6,82,6,6,41,216,175
2148,49,22,2,18,0,2,12,44,32
2149,69,516,0,21,0,0,5,537,532
2150,96,14,36,11,3,26,35,90,55
2151,23,2,8,10,12,14,23,46,23
2152,18,28,0,9,3,0,0,40,40
2153,8,530,142,217,62,9,56,960,904
2154,21,519,50,167,130,0,41,866,825
2155,60,611,76,749,59,45,26,1540,1514
2156,48,240,67,500,199,0,163,1006,843
2157,36,4,9,12,11,2,8,38,30
2158,36,671,47,655,145,111,15,1629,1614
2159,63,23,1,7,0,4,24,35,11
2160,2,9,1,2,3,2,0,17,17
2161,38,556,54,845,202,133,63,1790,1727
2162,61,833,80,363,52,26,174,1354,1180
2163,52,12,0,13,4,2,4,31,27
2164,25,56,7,48,10,2,18,123,105
2165,63,293,8,124,11,4,106,440,334
2166,10,297,0,38,13,0,152,348,196
2167,65,39,1,16,2,0,3,58,55
2168,71,5,11,16,21,8,45,61,16
2169,0,266,21,300,65,8,44,660,616
2170,3,322,3,50,4,3,42,382,340
2171,88,366,124,156,71,78,54,795,741
2172,15,32,0,8,23,4,18,67,49
2173,80,158,0,23,0,0,18,181,163
2174,17,269,129,495,182,43,29,1118,1089
2175,76,41,0,10,0,0,3,51,48
2176,52,3,3,3,15,4,15,28,13
2177,28,33,0,5,0,0,15,38,23
2178,31,302,29,131,32,0,27,494,467
2179,42,519,71,860,93,27,53,1570,1517
2180,24,23,2,17,2,1,0,45,45
2181,42,594,51,631,72,55,32,1403,1371
2182,12,12,4,7,1,3,5,27,22
2183,88,4,2,5,0,0,5,11,6
2184,67,18,3,19,3,3,6,46,40
2185,54,332,194,377,149,125,57,1177,1120
2186,40,5,1,8,0,0,1,14,13
2187,73,171,3,129,26,24,62,353,291
2188,81,270,31,88,11,48,22,448,426
2189,12,712,26,538,69,13,80,1358,1278
2190,7,2,8,11,3,8,21,32,11
2191,33,21,12,12,0,3,3,48,45
2192,24,580,6,58,8,0,27,652,625
2193,55,368,24,68,38,0,88,498,410
2194,87,457,5,106,15,17,53,600,547
2195,39,229,7,137,4,0,91,377,286
2196,9,3,2,8,20,0,17,33,16
2197,82,24,3,26,7,1,23,61,38
2198,71,853,10,143,13,10,20,1029,1009
2199,50,5,1,6,3,4,3,19,16
2200,81,3,3,7,6,2,9,21,12
2201,46,709,43,182,42,118,247,1094,847
2202,56,406,0,30,0,0,8,436,428
2203,91,908,48,217,32,12,24,1217,1193
2204,8,428,30,214,80,30,61,782,721
2205,40,84,3,61,2,1,21,151,130
